AB1_AMOEBIASIS	Amoebiasis
AB1_ANOGENITAL_HERPES_SIMPLEX	Anogenital herpesviral [herpes simplex] infection
AB1_ARTHROPOD	Arthropod-borne viral fevers and viral haemorrhagic fevers
AB1_ASPERGILLOSIS	Aspergillosis
AB1_ATYPICAL_CNS_VIRUS	Atypical virus infections of central nervous system
AB1_BACTINF_NOS	"Bacterial infection, other or unspecified"
AB1_BACT_BIR_OTHER_INF_AGENTS	"Bacterial, viral and other infectious agents"
AB1_BACT_INTEST_OTH	Other bacterial intestinal infections
AB1_CANDIDIASIS	Candidiasis
AB1_CHLAMYDIA_OTHER	Other sexually transmitted chlamydial diseases
AB1_CHOLERA	Cholera
AB1_CMV	Cytomegaloviral disease
AB1_DERMATOPHYTOSIS	Dermatophytosis
AB1_EARLY_SYPHILIS	Early syphilis
AB1_EBV	Infectious mononucleosis
AB1_ERYSIPELAS	Erysipelas
AB1_GASTROENTERITIS_NOS	Diarrhoea and gastroenteritis of presumed infectious origin
AB1_GHLAMY_OTHER	Other diseases caused by chlamydiae
AB1_GONOCOCCAL	Gonococcal infection
AB1_HELMINTIASES	Helminthiases
AB1_HEPATITIS_OTHER_VIRAL	Other  viral hepatitis
AB1_HERPES_SIMPLEX	Herpesviral [herpes simplex] infections
AB1_HIV	Human immunodeficiency virus [HIV] disease
AB1_HIV_NOS	Unspecified human immunodeficiency virus [HIV] disease
AB1_INFECTIONS	Certain infectious and parasitic diseases
AB1_INTESTINAL_INFECTIONS	Intestinal infectious diseases
AB1_LATE_SYPHILIS	Late syphilis
AB1_MALARIA	Malaria
AB1_MEASLES	Measles
AB1_MENINGOCOCCAL	Meningococcal infection
AB1_MUMPS	Mumps
AB1_MYCOSES	Mycoses
AB1_OTHER_BACTERIAL	Other bacterial diseases
AB1_OTHER_BACT_INOTHER	Other bacterial agents as the cause of diseases classified to other chapters
AB1_OTHER_CHLAMYDIAE	Other diseases caused by chlamydiae
AB1_OTHER_CONDITIONS	Human immunodeficiency virus [HIV] disease resulting in other conditions
AB1_OTHER_INFECTIONS	Other infectious diseases
AB1_OTHER_MYCOBAC	Infection due to other mycobacteria
AB1_OTHER_PROTOZOAL	Other protozoal intestinal diseases
AB1_OTHER_SEPSIS	Other septicaemia
AB1_OTHER_SPIROCHAETAL	Other spirochaetal diseases
AB1_OTHER_SUPERF_MYCOSIS	Other superficial mycoses
AB1_OTHER_VIRAL	Other viral diseases
AB1_PARASITIC_NOS	Unspecified parasitic disease
AB1_PEDICULOSIS_ACARIASIS_OTHERINFEST	"Pediculosis, acariasis and other infestations"
AB1_PNEUMOCYSTOSIS	Pneumocystosis
AB1_POLIOMYELITIS	Acute poliomyelitis
AB1_PROTOZOAL	Protozoal diseases
AB1_RESP_TUBERCU	Respiratry tuberculosis
AB1_RESP_TUBERCU_CONF	"Respiratory tuberculosis, bacteriologically and histologically confirmed"
AB1_RESP_TUBERCU_NONCONF	"Respiratory tuberculosis, not confirmed bacteriologically or histologically"
AB1_RUBELLA	Rubella [German measles]
AB1_SALMONELLA_OTH	Other salmonella infections
AB1_SCABIES	Scabies
AB1_SCARLET_FEVER	Scarlet fever
AB1_SCHISTOSOMIASIS	Schistosomiasis [bilharziasis]
AB1_SEPSIS	Septicaemia
AB1_SEQULAE_INF_NOS	Sequelae of other and unspecified infectious and parasitic diseases
AB1_SEQULAE_POLIO	Sequelae of poliomyelitis
AB1_SEQULAE_TUBERCU	Sequelae of tuberculosis
AB1_SEQULEAE_OF_INFECTIONS_AND_PARASITES	Sequelae of infectious and parasitic diseases
AB1_SEXUAL_TRANSMISSION	Infections with a predominantly sexual mode of transmission
AB1_SEXUAL_TRANSMISSION_NOS	"Other predominantly sexually transmitted diseases, not elsewhere classified"
AB1_SPIROCHE_OTHER	"Spirochaetal infections, other/unspecified"
AB1_STREPTO_SEPSIS	Streptococcal septicaemia
AB1_STREPTSTAPHYCOCC_INOTHER	Streptococcus and staphylococcus as the cause of diseases classified to other chapters
AB1_SYPHILIS	Syphilis
AB1_TOXOPLASMOSIS	Toxoplasmosis
AB1_TRICHOMONIASIS	Trichomoniasis
AB1_TUBERCULOSIS	Tuberculosis
AB1_TUBERCU_OTH_ORG	Tuberculosis of other organs
AB1_TULARAEMIA	Tularaemia
AB1_VARICELLA	Varicella [chickenpox]
AB1_VIRAAL_CONJUNCT	Viral conjunctivitis
AB1_VIRAL_CNS	Viral infections of the central nervous system
AB1_VIRAL_ENCEPHALITIS_NOS	"Viral encephalitis, not elsewhere classified/unspecified"
AB1_VIRAL_HEMOR_FEVER_NOS	"Viral haemorrhagic fevers, not elsewhere classified/unspecified"
AB1_VIRAL_HEPATITIS	Viral hepatitis
AB1_VIRAL_INOTHER	Viral agents as the cause of diseases classified to other chapters
AB1_VIRAL_MENINGITIS	Viral meningitis
AB1_VIRAL_NOS	"Other viral diseases, not elsewhere classified"
AB1_VIRAL_OTHER_INTEST_INFECTIONS	Viral and other specified intestinal infections
AB1_VIRAL_SKIN_MUCOUS_MEMBRANE	Viral infections characterized by skin and mucous membrane lesions
AB1_VIRAL_SKIN_NOS	"Other viral infections characterized by skin and mucous membrane lesions, not elsewhere classified"
AB1_VIRAL_WARTS	Viral warts
AB1_VIRAN_CNS_INFECTIONS_NOS	"Viral infections of central nervous system, not elsewhere classified/unspecified"
AB1_WHOOPCOUGH	Whooping cough
AB1_ZOONOTIC_BACTERIAL	Certain zoonotic bacterial diseases
AB1_ZOSTER	Zoster [herpes zoster]
ABDOM_HERNIA	Hernia of abodminal wall
ABDOM_HERNIA_POSTOP	"Hernia of abodminal wall, postoperative"
ACUTE_DRUGADVERS_INTERSTITIAL_LUNG_DISORD	Acute drug-induced interstitial lung disorder
ACUTE_RESPIRATORY_INFECTIONS	Asthma/COPD-related acute respiratory infections
AD_AM	AlzheimerÕs disease (Atypical or mixed)
AD_AM_EXMORE	AlzheimerÕs disease (Atypical or mixed) (more controls excluded)
AD_EO	AlzheimerÕs disease (Early onset)
AD_EO_EXMORE	AlzheimerÕs disease (Early onset) (more controls excluded)
AD_LO	AlzheimerÕs disease (Late onset)
AD_LO_EXMORE	AlzheimerÕs disease (Late onset) (more controls excluded)
AD_U	AlzheimerÕs disease (undefined)
AD_U_EXMORE	AlzheimerÕs disease (undefined) (more controls excluded)
AF_OPER	Operations for atrial fibrillation
ALCODELIRIUM	Alcohol withdrawal state with deliriumÊ
ALCOGASTRITIS	Alcoholic gastritis
ALCOHOLACUTE10	Acute alcohol intoxication
ALCOHOLACUTE9	Acute alcohol intoxication ICD-9
ALCOHOLMENTAL	"Mental and behavioural disorders due to alcohol, excluding acute intoxication"
ALCOHOL_RELATED	"Alcohol related diseases and deaths, all endoints"
ALCOLIVER	Alcoholic liver disease
ALCONEURODEGEN	Degeneration of nervous system due to alcohol
ALCOPANCACU	Acohol-induced acute pancreatitis
ALCOPANCCHRON	Alcohol-induced chronic pancreatitis
ALCOPOLYNEU	Alcohol induced polyneuropathy
ALCO_PRESCRIPTION	"Use of disulfiram, acamprosate or naltrexone"
ALLERGIC_CONTACT_DERMA_DRUGS_CONTACT_W_SKIN	Allergic contact dermatitis due to drugs in contact with skin
ALLERG_ASTHMA	Allergic asthma (mode)
ALLERG_ASTHMA_EXMORE	Allergic asthma (mode) (more controls excluded)
ALLERG_RHINITIS	Allergic rhinitis
AMN2	Transient global amnesia
AMPUTATION	Amputation
AMPUTATION_ANKLEBONES	Amputation of ankle bones
AMPUTATION_FOOT	Amputation of foot
AMPUTATION_THIGH	Amputation of thigh
AMPUTATION_TOE	Amputation of toe
ANAPH_SHOCK_ADVER_EFFECT_CORRE_DRUG_MEDICAM_PROPE_ADMINISTE	Anaphylactic shock due to adverse effect of correct drug or medicament properly administered
ANOSMIA	Anosmia
ANTIDEPRESSANTS	Depression medications
ANY_HILMO	Any event in hilmo or specialist outpatient
ANY_OPER	Any operation in hilmo
APPENDACUT_COMPLIC	"Acute appendicitis, with complications"
APPENDACUT_NOCOMPLIC	"Acute appendicitis, no complications"
APPENDICITIS_BROAD	"Appendicitis, broad definition"
ARTHROSIS_COMORB	Arthrosis related co-morbidities
ARTHRO_SPEC	Other specific arthropathies
ARTRHO_POSTDYSENTERIC	Postydysenteric arthropathy
ASTHMA_ACUTE_RESPIRATORY_INFECTIONS	Asthma-related acute respiratory infections
ASTHMA_ALLERG	Asthma and allergy
ASTHMA_ALLERG_EXMORE	Asthma and allergy (more controls excluded)
ASTHMA_CHILD	Childhood asthma (age<16)
ASTHMA_CHILD_EXMORE	Childhood asthma (age<16) (more controls excluded)
ASTHMA_COMORB	Asthma associated co-morbidites
ASTHMA_CVDMETABOCOMORB	"Co-morbidites, CVD and metabolic diseases"
ASTHMA_EOSINOPHIL_SUGG	Suggestive for eosinophilic asthma
ASTHMA_EXCL	Excluding asthma or asthma-COPD overlap
ASTHMA_HOSPITAL_INFECTIONS	"Asthma, hospital admission 2, infections"
ASTHMA_HOSPITAL_MAIN	"Asthma, hospital admissions , main diagnosis only"
ASTHMA_HOSPITAL_PNEUMONIA	"Asthma, hospital admissions 3, pneumonia"
ASTHMA_IMMUNECOMORB	Immune disease comorbidities
ASTHMA_INFECTIONS	Asthma-related infections
ASTHMA_MEDICATIO_COMORB	Medication related adverse effects
ASTHMA_MIXED	Asthma mixed form (mode)
ASTHMA_MIXED_EXMORE	Asthma mixed form (mode) (more controls excluded)
ASTHMA_MODE	Asthma (mode)
ASTHMA_NAS	"Asthma, unspecified (mode)"
ASTHMA_NAS_EXMORE	"Asthma, unspecified (mode)" (more controls excluded)
ASTHMA_NONALLERG	Non-allergic asthma
ASTHMA_NOS	Undetermined asthma
ASTHMA_NOS_EXMORE	Undetermined asthma (more controls excluded)
ASTHMA_OBESITY	Obesity related asthma
ASTHMA_OPPORTUNIST_INFECTIONS	Asthma and opportunit respiratory infection
ASTHMA_PNEUMONIA	Asthma-related pneumonia
ASTHMA_PNEUMONIA_AND_SEPSIS	Asthma-related pneumonia or sepsis
ASTHMA_PSYCH_COMORB	Psychiatric comorbidites
ASTHMA_SEPTICHE_PNEUMONIA	Pneumonia derived septichemia
ATOPIC_STRICT	"Atopic  dermatitis, strict definition"
ATOPIC_STRICT_REIMB	"Atopic dermatitis, strict definition with reimbursement"
AUD	"Alcohol use disorder, ICD-based"
AUD_SWEDISH	"Alcohol use disorder, Swedish definition"
AUTOIMMUNE	Autoimmune diseases
AUTOIMMUNE_HYPERTHYROIDISM	Autoimmune hyperthyroidism
BACT_INTEST_INFECTION_NOS	Other specified/unspecified bacterial intestinal infections
BRONCHITIS	Bronchitis
C3_AML	Acute myeloid leukaemia
C3_AML_EXALLC	Acute myeloid leukaemia (all cancers excluded)
C3_ANUS_ANALCANAL	Malignant neoplasm of anus and anal canal
C3_ANUS_ANALCANAL_EXALLC	Malignant neoplasm of anus and anal canal (all cancers excluded)
C3_BILIARY_TRACT	Malignant neoplasm of other and unspecified parts of biliary tract
C3_BILIARY_TRACT_EXALLC	Malignant neoplasm of other and unspecified parts of biliary tract (all cancers excluded)
C3_BLADDER	Malignant neoplasm of bladder
C3_BLADDER_EXALLC	Malignant neoplasm of bladder (all cancers excluded)
C3_BONE_CARTILAGE	Malignant neoplasm of bone and articular cartilage
C3_BONE_CARTILAGE_EXALLC	Malignant neoplasm of bone and articular cartilage (all cancers excluded)
C3_BRAIN	Malignant neoplasm of brain
C3_BRAIN_EXALLC	Malignant neoplasm of brain (all cancers excluded)
C3_BREAST	Malignant neoplasm of breast
C3_BREAST_EXALLC	Malignant neoplasm of breast (all cancers excluded)
C3_BREAST_HER2NEG	"Malignant neoplasm of breast, HER2-negative"
C3_BREAST_HER2NEG_EXALLC	"Malignant neoplasm of breast, HER2-negative" (all cancers excluded)
C3_BREAST_HERNEG	"Malignant neoplasm of breast, HER-negative"
C3_BREAST_HERNEG_EXALLC	"Malignant neoplasm of breast, HER-negative" (all cancers excluded)
C3_BREAST_HERPLUS	"Malignant neoplasm of breast, HER-positive"
C3_BREAST_HERPLUS_EXALLC	"Malignant neoplasm of breast, HER-positive" (all cancers excluded)
C3_BRONCHUS_LUNG	Malignant neoplasm of bronchus and lung
C3_BRONCHUS_LUNG_EXALLC	Malignant neoplasm of bronchus and lung (all cancers excluded)
C3_CANCER	Malignant neoplasm
C3_CERVIX_UTERI	Malignant neoplasm of cervix uteri
C3_CERVIX_UTERI_EXALLC	Malignant neoplasm of cervix uteri (all cancers excluded)
C3_CLL	Chronic lymphocytic leukaemia
C3_CLL_EXALLC	Chronic lymphocytic leukaemia (all cancers excluded)
C3_COLON	Malignant neoplasm of colon
C3_COLON_ADENO	Colon adenocarcinoma
C3_COLON_ADENO_EXALLC	Colon adenocarcinoma (all cancers excluded)
C3_COLON_EXALLC	Malignant neoplasm of colon (all cancers excluded)
C3_COLORECTAL	Colorectal cancer
C3_COLORECTAL_EXALLC	Colorectal cancer (all cancers excluded)
C3_CONNECTIVE_SOFT_NAS	Malignant neoplasm of other connective and soft tissue
C3_CONNECTIVE_SOFT_NAS_EXALLC	Malignant neoplasm of other connective and soft tissue (all cancers excluded)
C3_CORPUS_UTERI	Malignant neoplasm of corpus uteri
C3_CORPUS_UTERI_EXALLC	Malignant neoplasm of corpus uteri (all cancers excluded)
C3_DIGESTIVE_ORGANS	Malignant neoplasm of digestive organs
C3_DIGESTIVE_ORGANS_EXALLC	Malignant neoplasm of digestive organs (all cancers excluded)
C3_DLBCL	Diffuse large B-cell lymphoma
C3_DLBCL_EXALLC	Diffuse large B-cell lymphoma (all cancers excluded)
C3_ENDOCRINE	Malignant neoplasm of endocrine gland
C3_ENDOCRINE_EXALLC	Malignant neoplasm of endocrine gland (all cancers excluded)
C3_EYE_ADNEXA	Malignant neoplasm of eye and adnexa
C3_EYE_ADNEXA_EXALLC	Malignant neoplasm of eye and adnexa (all cancers excluded)
C3_EYE_BRAIN_NEURO	"Malignant neoplasm of eye, brain and central nervous system"
C3_EYE_BRAIN_NEURO_EXALLC	"Malignant neoplasm of eye, brain and central nervous system" (all cancers excluded)
C3_FEMALE_GENITAL	malignant neoplasm of female genital organs
C3_FEMALE_GENITAL_EXALLC	malignant neoplasm of female genital organs (all cancers excluded)
C3_FEMALE_GENITAL_NAS	Malignant neoplasm of other and unspecified female genital organs
C3_FEMALE_GENITAL_NAS_EXALLC	Malignant neoplasm of other and unspecified female genital organs (all cancers excluded)
C3_GBM	Brain glioblastoma
C3_GBM_EXALLC	Brain glioblastoma (all cancers excluded)
C3_HEART_MEDIASTINUM_PLEURA	"Malignant neoplasm of heart, mediastinum and pleura"
C3_HEART_MEDIASTINUM_PLEURA_EXALLC	"Malignant neoplasm of heart, mediastinum and pleura" (all cancers excluded)
C3_KIDNEY_NOTRENALPELVIS	"Malignant neoplasm of kidney, except renal pelvis"
C3_KIDNEY_NOTRENALPELVIS_EXALLC	"Malignant neoplasm of kidney, except renal pelvis" (all cancers excluded)
C3_LARYNX	Malignant neoplasm of larynx
C3_LARYNX_EXALLC	Malignant neoplasm of larynx (all cancers excluded)
C3_LIP_ORAL_PHARYNX	"Malignant neoplasm of lip, oral cavity and pharynx"
C3_LIP_ORAL_PHARYNX_EXALLC	"Malignant neoplasm of lip, oral cavity and pharynx" (all cancers excluded)
C3_LIVER_INTRAHEPATIC_BILE_DUCTS	Malignant neoplasm of liver and intrahepatic bile ducts
C3_LIVER_INTRAHEPATIC_BILE_DUCTS_EXALLC	Malignant neoplasm of liver and intrahepatic bile ducts (all cancers excluded)
C3_LUNG_NONSMALL	Non-small cell lung cancer
C3_LUNG_NONSMALL_EXALLC	Non-small cell lung cancer (all cancers excluded)
C3_LYMPHNODES_SECONDARY_NAS	Secondary and unspecified malignant neoplasm of lymph nodes
C3_LYMPHNODES_SECONDARY_NAS_EXALLC	Secondary and unspecified malignant neoplasm of lymph nodes (all cancers excluded)
C3_MALE_GENITAL	malignant neoplasm of male genital organs
C3_MALE_GENITAL_EXALLC	malignant neoplasm of male genital organs (all cancers excluded)
C3_MELANOMA_SKIN	Malignant melanoma of skin
C3_MELANOMA_SKIN_EXALLC	Malignant melanoma of skin (all cancers excluded)
C3_MENINGES	Malignant neoplasm of meninges
C3_MENINGES_EXALLC	Malignant neoplasm of meninges (all cancers excluded)
C3_MESOTHELIOMA	Mesothelioma
C3_MESOTHELIOMA_EXALLC	Mesothelioma (all cancers excluded)
C3_MESTOTHEL_SOFTTISSUE	Melignant neoplasm of mesothelium and soft tissue
C3_MESTOTHEL_SOFTTISSUE_EXALLC	Melignant neoplasm of mesothelium and soft tissue (all cancers excluded)
C3_NSCLC_ADENO	"Non-small cell lung cancer, adenocarcinoma"
C3_NSCLC_ADENO_EXALLC	"Non-small cell lung cancer, adenocarcinoma" (all cancers excluded)
C3_NSCLC_SQUAM	"Non-small cell lung cancer, squamous"
C3_NSCLC_SQUAM_EXALLC	"Non-small cell lung cancer, squamous" (all cancers excluded)
C3_OESOPHAGUS	Malignant neoplasm of oesophagus
C3_OESOPHAGUS_EXALLC	Malignant neoplasm of oesophagus (all cancers excluded)
C3_OTHER_SKIN	Other malignant neoplasms of skin (=non-melanoma skin cancer)
C3_OTHER_SKIN_EXALLC	Other malignant neoplasms of skin (=non-melanoma skin cancer) (all cancers excluded)
C3_OVARY	Malignant neoplasm of ovary
C3_OVARY_EXALLC	Malignant neoplasm of ovary (all cancers excluded)
C3_PANCREAS	Malignant neoplasm of pancreas
C3_PANCREAS_EXALLC	Malignant neoplasm of pancreas (all cancers excluded)
C3_PROSTATE	Malignant neoplasm of prostate
C3_PROSTATE_EXALLC	Malignant neoplasm of prostate (all cancers excluded)
C3_RECTOSIGMOID_JUNCTION	Malignant neoplasm of rectosigmoid junction
C3_RECTOSIGMOID_JUNCTION_EXALLC	Malignant neoplasm of rectosigmoid junction (all cancers excluded)
C3_RECTUM	Malignant neoplasm of rectum
C3_RECTUM_EXALLC	Malignant neoplasm of rectum (all cancers excluded)
C3_RESPIRATORY_INTRATHORACIC	Malignant neoplasm of respiratory system and intrathoracic organs
C3_RESPIRATORY_INTRATHORACIC_EXALLC	Malignant neoplasm of respiratory system and intrathoracic organs (all cancers excluded)
C3_SCLC	Small cell lung cancer
C3_SCLC_EXALLC	Small cell lung cancer (all cancers excluded)
C3_SECONDARY_NAS	Secondary malignant neoplasm of other and unspecified sites
C3_SECONDARY_NAS_EXALLC	Secondary malignant neoplasm of other and unspecified sites (all cancers excluded)
C3_SECONDARY_WITHOUT_SITESPEC	"Malignant neoplasm, without specification of site"
C3_SECONDARY_WITHOUT_SITESPEC_EXALLC	"Malignant neoplasm, without specification of site" (all cancers excluded)
C3_SKIN	Malignant neoplasm of skin
C3_SKIN_EXALLC	Malignant neoplasm of skin (all cancers excluded)
C3_SMALL_INTESTINE	Malignant neoplasm of small intestine
C3_SMALL_INTESTINE_EXALLC	Malignant neoplasm of small intestine (all cancers excluded)
C3_SPINAL_CORD_CRANIAL_AND_OTHER_CNS	"Malignant neoplasm of spinal cord, cranial nerves and other parts of central nervous system"
C3_SPINAL_CORD_CRANIAL_AND_OTHER_CNS_EXALLC	"Malignant neoplasm of spinal cord, cranial nerves and other parts of central nervous system" (all cancers excluded)
C3_STOMACH	Malignant neoplasm of stomach
C3_STOMACH_EXALLC	Malignant neoplasm of stomach (all cancers excluded)
C3_TESTIS	Malignant neoplasm of testis
C3_TESTIS_EXALLC	Malignant neoplasm of testis (all cancers excluded)
C3_THYROID_GLAND	Malignant neoplasm of thyroid gland
C3_THYROID_GLAND_EXALLC	Malignant neoplasm of thyroid gland (all cancers excluded)
C3_UNCERTAIN_SECONDARY	Secondary uncertain malignant neoplasm
C3_UNCERTAIN_SECONDARY_EXALLC	Secondary uncertain malignant neoplasm (all cancers excluded)
C3_URINARY_TRACT	Malignant neoplasm of urinary organs
C3_URINARY_TRACT_EXALLC	Malignant neoplasm of urinary organs (all cancers excluded)
C3_VULVA	Malignant neoplasm of vulva
C3_VULVA_EXALLC	Malignant neoplasm of vulva (all cancers excluded)
CAMPYLOENTERITIS	Campylobacter enteritis
CARDIAC_ARRHYTM	Cardiac arrhytmias
CARDIOVERSION	Cardiodefibrillation
CD2_BENIGN	Benign neoplasms
CD2_BENIGN_ADRENAL	Benign neoplasm: Adrenal gland
CD2_BENIGN_ADRENAL_EXALLC	Benign neoplasm: Adrenal gland (all cancers excluded)
CD2_BENIGN_ANUS_ANAL_CANAL	Benign neoplasm: Anus and anal canal
CD2_BENIGN_ANUS_ANAL_CANAL_EXALLC	Benign neoplasm: Anus and anal canal (all cancers excluded)
CD2_BENIGN_APPENDIX	Benign neoplasm: Appendix
CD2_BENIGN_APPENDIX_EXALLC	Benign neoplasm: Appendix (all cancers excluded)
CD2_BENIGN_ASCENDING_COLON	Benign neoplasm: Ascending colon
CD2_BENIGN_ASCENDING_COLON_EXALLC	Benign neoplasm: Ascending colon (all cancers excluded)
CD2_BENIGN_BLADDER	Benign neoplasm: Bladder
CD2_BENIGN_BLADDER_EXALLC	Benign neoplasm: Bladder (all cancers excluded)
CD2_BENIGN_BONE_CARTILAGE	Benign neoplasm of bone and articular cartilage
CD2_BENIGN_BONE_CARTILAGE_EXALLC	Benign neoplasm of bone and articular cartilage (all cancers excluded)
CD2_BENIGN_BONE_CARTILAGE_NOS	"Benign neoplasm: Bone and articular cartilage, unspecified"
CD2_BENIGN_BONE_CARTILAGE_NOS_EXALLC	"Benign neoplasm: Bone and articular cartilage, unspecified" (all cancers excluded)
CD2_BENIGN_BONE_LONG_LOWER	Benign neoplasm: Long bones of lower limb
CD2_BENIGN_BONE_LONG_LOWER_EXALLC	Benign neoplasm: Long bones of lower limb (all cancers excluded)
CD2_BENIGN_BONE_SCAPULA_LONG_UPPER	Benign neoplasm: Scapula and long bones of upper limb
CD2_BENIGN_BONE_SCAPULA_LONG_UPPER_EXALLC	Benign neoplasm: Scapula and long bones of upper limb (all cancers excluded)
CD2_BENIGN_BONE_SHORT_LOWER	Benign neoplasm: Short bones of lower limb
CD2_BENIGN_BONE_SHORT_LOWER_EXALLC	Benign neoplasm: Short bones of lower limb (all cancers excluded)
CD2_BENIGN_BONE_SHORT_UPPER	Benign neoplasm: Short bones of upper limb
CD2_BENIGN_BONE_SHORT_UPPER_EXALLC	Benign neoplasm: Short bones of upper limb (all cancers excluded)
CD2_BENIGN_BONE_SKULL_FACE	Benign neoplasm: Bones of skull and face
CD2_BENIGN_BONE_SKULL_FACE_EXALLC	Benign neoplasm: Bones of skull and face (all cancers excluded)
CD2_BENIGN_BRAIN_CNS	Benign neoplasm of brain and other parts of central nervous system
CD2_BENIGN_BRAIN_CNS_EXALLC	Benign neoplasm of brain and other parts of central nervous system (all cancers excluded)
CD2_BENIGN_BRAIN_NOS	"Benign neoplasm: Brain, unspecified"
CD2_BENIGN_BRAIN_NOS_EXALLC	"Benign neoplasm: Brain, unspecified" (all cancers excluded)
CD2_BENIGN_BRAIN_SUPRATENT	"Benign neoplasm: Brain, supratentorial"
CD2_BENIGN_BRAIN_SUPRATENT_EXALLC	"Benign neoplasm: Brain, supratentorial" (all cancers excluded)
CD2_BENIGN_BREAST	Benign neoplasm of breast
CD2_BENIGN_BREAST_EXALLC	Benign neoplasm of breast (all cancers excluded)
CD2_BENIGN_BRONCHUS_LUNG	Benign neoplasm: Bronchus and lung
CD2_BENIGN_BRONCHUS_LUNG_EXALLC	Benign neoplasm: Bronchus and lung (all cancers excluded)
CD2_BENIGN_CAECUM	Benign neoplasm: Caecum
CD2_BENIGN_CAECUM_EXALLC	Benign neoplasm: Caecum (all cancers excluded)
CD2_BENIGN_CHOROID	Benign neoplasm: Choroid
CD2_BENIGN_CHOROID_EXALLC	Benign neoplasm: Choroid (all cancers excluded)
CD2_BENIGN_COLON	Benign neoplasm: Colon
CD2_BENIGN_COLON_EXALLC	Benign neoplasm: Colon (all cancers excluded)
CD2_BENIGN_COLON_NOS	"Benign neoplasm: Colon, unspecified"
CD2_BENIGN_COLON_NOS_EXALLC	"Benign neoplasm: Colon, unspecified" (all cancers excluded)
CD2_BENIGN_COLORECANI	"Benign neoplasm of colon, rectum, anus and anal canal"
CD2_BENIGN_COLORECANI_EXALLC	"Benign neoplasm of colon, rectum, anus and anal canal" (all cancers excluded)
CD2_BENIGN_CONJUNCTIVA	Benign neoplasm: Conjunctiva
CD2_BENIGN_CONJUNCTIVA_EXALLC	Benign neoplasm: Conjunctiva (all cancers excluded)
CD2_BENIGN_CONNECTIVE_SOFT	Other benign neoplasms of connective and other soft tissue
CD2_BENIGN_CONNECTIVE_SOFT_EXALLC	Other benign neoplasms of connective and other soft tissue (all cancers excluded)
CD2_BENIGN_CONNSOFT_HEADFACETRUNK	"Benign neoplasm: Connective and other soft tissue of head, face and neck"
CD2_BENIGN_CONNSOFT_HEADFACETRUNK_EXALLC	"Benign neoplasm: Connective and other soft tissue of head, face and neck" (all cancers excluded)
CD2_BENIGN_CONNSOFT_LOWERLIMB	"Benign neoplasm: Connective and other soft tissue of lower limb, including hip"
CD2_BENIGN_CONNSOFT_LOWERLIMB_EXALLC	"Benign neoplasm: Connective and other soft tissue of lower limb, including hip" (all cancers excluded)
CD2_BENIGN_CONNSOFT_NOS	"Benign neoplasm: Connective and other soft tissue, unspecified"
CD2_BENIGN_CONNSOFT_NOS_EXALLC	"Benign neoplasm: Connective and other soft tissue, unspecified" (all cancers excluded)
CD2_BENIGN_CONNSOFT_TRUNK	"Benign neoplasm: Connective and other soft tissue of trunk, unspecified"
CD2_BENIGN_CONNSOFT_TRUNK_EXALLC	"Benign neoplasm: Connective and other soft tissue of trunk, unspecified" (all cancers excluded)
CD2_BENIGN_CONNSOFT_UPPERLIMB	"Benign neoplasm: Connective and other soft tissue of upper limb, including shoulder"
CD2_BENIGN_CONNSOFT_UPPERLIMB_EXALLC	"Benign neoplasm: Connective and other soft tissue of upper limb, including shoulder" (all cancers excluded)
CD2_BENIGN_CORPUS_UTERI	Other benign neoplasm of uterus: Corpus uteri
CD2_BENIGN_CORPUS_UTERI_EXALLC	Other benign neoplasm of uterus: Corpus uteri (all cancers excluded)
CD2_BENIGN_CRANIAL_NERVE	Benign neoplasm: Cranial nerves
CD2_BENIGN_CRANIAL_NERVE_EXALLC	Benign neoplasm: Cranial nerves (all cancers excluded)
CD2_BENIGN_DESCENDING_COLON	Benign neoplasm: Descending colon
CD2_BENIGN_DESCENDING_COLON_EXALLC	Benign neoplasm: Descending colon (all cancers excluded)
CD2_BENIGN_DUODENUM	Benign neoplasm: Duodenum
CD2_BENIGN_DUODENUM_EXALLC	Benign neoplasm: Duodenum (all cancers excluded)
CD2_BENIGN_EAR_NASAL_SINUS	"Benign neoplasm: Middle ear, nasal cavity and accessory sinuses"
CD2_BENIGN_EAR_NASAL_SINUS_EXALLC	"Benign neoplasm: Middle ear, nasal cavity and accessory sinuses" (all cancers excluded)
CD2_BENIGN_EAR_RESP	Benign neoplasm of middle ear and respiratory system
CD2_BENIGN_EAR_RESP_EXALLC	Benign neoplasm of middle ear and respiratory system (all cancers excluded)
CD2_BENIGN_ENDOCRINE_OTH	Benign neoplasm of other and unspecified endocrine glands
CD2_BENIGN_ENDOCRINE_OTH_EXALLC	Benign neoplasm of other and unspecified endocrine glands (all cancers excluded)
CD2_BENIGN_EXALLC	Benign neoplasms (all cancers excluded)
CD2_BENIGN_EYE	Benign neoplasm of eye and adnexa
CD2_BENIGN_EYE_EXALLC	Benign neoplasm of eye and adnexa (all cancers excluded)
CD2_BENIGN_FEMALE_GEN_OTH	Benign neoplasm of other and unspecified female genital organs
CD2_BENIGN_FEMALE_GEN_OTH_EXALLC	Benign neoplasm of other and unspecified female genital organs (all cancers excluded)
CD2_BENIGN_HEAMANGIOMA_LYMPHANGIOMA	"Haemangioma and lymphangioma, any site"
CD2_BENIGN_HEAMANGIOMA_LYMPHANGIOMA_EXALLC	"Haemangioma and lymphangioma, any site" (all cancers excluded)
CD2_BENIGN_HEMANGIOMA	"Haemangioma, any site"
CD2_BENIGN_HEMANGIOMA_EXALLC	"Haemangioma, any site" (all cancers excluded)
CD2_BENIGN_INTRATHORACIC	Benign neoplasm of other and unspecified intrathoracic organs
CD2_BENIGN_INTRATHORACIC_EXALLC	Benign neoplasm of other and unspecified intrathoracic organs (all cancers excluded)
CD2_BENIGN_KIDNEY	Benign neoplasm: Kidney
CD2_BENIGN_KIDNEY_EXALLC	Benign neoplasm: Kidney (all cancers excluded)
CD2_BENIGN_LARYNX	Benign neoplasm: Larynx
CD2_BENIGN_LARYNX_EXALLC	Benign neoplasm: Larynx (all cancers excluded)
CD2_BENIGN_LEIOMYOMA_UTERI	Leiomyoma of uterus
CD2_BENIGN_LEIOMYOMA_UTERI_EXALLC	Leiomyoma of uterus (all cancers excluded)
CD2_BENIGN_LIP	Benign neoplasm: Lip
CD2_BENIGN_LIPOMATOUS	Benign lipomatous neoplasm
CD2_BENIGN_LIPOMATOUS_EXALLC	Benign lipomatous neoplasm (all cancers excluded)
CD2_BENIGN_LIPO_NOS	Benign lipomatous neoplasm of other sites/unspecified
CD2_BENIGN_LIPO_NOS_EXALLC	Benign lipomatous neoplasm of other sites/unspecified (all cancers excluded)
CD2_BENIGN_LIPO_SKIN_HEADFACENECK	"Benign lipomatous neoplasm of skin and subcutaneous tissue of head, face and neck"
CD2_BENIGN_LIPO_SKIN_HEADFACENECK_EXALLC	"Benign lipomatous neoplasm of skin and subcutaneous tissue of head, face and neck" (all cancers excluded)
CD2_BENIGN_LIPO_SKIN_LIMBS	Benign lipomatous neoplasm of skin and subcutaneous tissue of limbs
CD2_BENIGN_LIPO_SKIN_LIMBS_EXALLC	Benign lipomatous neoplasm of skin and subcutaneous tissue of limbs (all cancers excluded)
CD2_BENIGN_LIPO_SKIN_NOS	Benign lipomatous neoplasm of skin and subcutaneous tissue of other and unspecified sites
CD2_BENIGN_LIPO_SKIN_NOS_EXALLC	Benign lipomatous neoplasm of skin and subcutaneous tissue of other and unspecified sites (all cancers excluded)
CD2_BENIGN_LIPO_SKIN_TRUNK	Benign lipomatous neoplasm of skin and subcutaneous tissue of trunk
CD2_BENIGN_LIPO_SKIN_TRUNK_EXALLC	Benign lipomatous neoplasm of skin and subcutaneous tissue of trunk (all cancers excluded)
CD2_BENIGN_LIP_EXALLC	Benign neoplasm: Lip (all cancers excluded)
CD2_BENIGN_LIVER	Benign neoplasm: Liver
CD2_BENIGN_LIVER_EXALLC	Benign neoplasm: Liver (all cancers excluded)
CD2_BENIGN_LIVE_BILE	Benign neoplasm: Liver/bile ducts
CD2_BENIGN_LIVE_BILE_EXALLC	Benign neoplasm: Liver/bile ducts (all cancers excluded)
CD2_BENIGN_LYMPHANGIOMA	"Lymphangioma, anys site"
CD2_BENIGN_LYMPHANGIOMA_EXALLC	"Lymphangioma, anys site" (all cancers excluded)
CD2_BENIGN_MALE_GEN	Benign neoplasm of male genital organs
CD2_BENIGN_MALE_GEN_EXALLC	Benign neoplasm of male genital organs (all cancers excluded)
CD2_BENIGN_MELANOCYTIC	Melanocytic naevi
CD2_BENIGN_MELANOCYTIC_EXALLC	Melanocytic naevi (all cancers excluded)
CD2_BENIGN_MELANOCYTIC_EYELID	"Melanocytic naevi of eyelid, including canthus"
CD2_BENIGN_MELANOCYTIC_EYELID_EXALLC	"Melanocytic naevi of eyelid, including canthus" (all cancers excluded)
CD2_BENIGN_MELANOCYTIC_FACE	Melanocytic naevi of other and unspecified parts of face
CD2_BENIGN_MELANOCYTIC_FACE_EXALLC	Melanocytic naevi of other and unspecified parts of face (all cancers excluded)
CD2_BENIGN_MELANOCYTIC_LIP	Melanocytic naevi of lip
CD2_BENIGN_MELANOCYTIC_LIP_EXALLC	Melanocytic naevi of lip (all cancers excluded)
CD2_BENIGN_MELANOCYTIC_LOWERLIMB	"Melanocytic naevi of lower limb, including hip"
CD2_BENIGN_MELANOCYTIC_LOWERLIMB_EXALLC	"Melanocytic naevi of lower limb, including hip" (all cancers excluded)
CD2_BENIGN_MELANOCYTIC_NOS	"Melanocytic naevi, other sites/unspecified"
CD2_BENIGN_MELANOCYTIC_NOS_EXALLC	"Melanocytic naevi, other sites/unspecified" (all cancers excluded)
CD2_BENIGN_MELANOCYTIC_SCALPNECK	Melanocytic naevi of scalp and neck
CD2_BENIGN_MELANOCYTIC_SCALPNECK_EXALLC	Melanocytic naevi of scalp and neck (all cancers excluded)
CD2_BENIGN_MELANOCYTIC_TRUNK	Melanocytic naevi of trunk
CD2_BENIGN_MELANOCYTIC_TRUNK_EXALLC	Melanocytic naevi of trunk (all cancers excluded)
CD2_BENIGN_MELANOCYTIC_UPPERLIMB	"Melanocytic naevi of upper limb, including shoulder"
CD2_BENIGN_MELANOCYTIC_UPPERLIMB_EXALLC	"Melanocytic naevi of upper limb, including shoulder" (all cancers excluded)
CD2_BENIGN_MENINGES	Benign neoplasm of meninges
CD2_BENIGN_MENINGES_CEREBRAL	Benign neoplasm: Cerebral meninges
CD2_BENIGN_MENINGES_CEREBRAL_EXALLC	Benign neoplasm: Cerebral meninges (all cancers excluded)
CD2_BENIGN_MENINGES_EXALLC	Benign neoplasm of meninges (all cancers excluded)
CD2_BENIGN_MENINGES_NOS	"Beningn neoplasm: Meninges, unspecified"
CD2_BENIGN_MENINGES_NOS_EXALLC	"Beningn neoplasm: Meninges, unspecified" (all cancers excluded)
CD2_BENIGN_MENINGES_SPINAL	Benign neoplasm: Spinal meninges
CD2_BENIGN_MENINGES_SPINAL_EXALLC	Benign neoplasm: Spinal meninges (all cancers excluded)
CD2_BENIGN_MOUTH_NOS	Benign neoplasm: Other and unspecified parts of mouth
CD2_BENIGN_MOUTH_NOS_EXALLC	Benign neoplasm: Other and unspecified parts of mouth (all cancers excluded)
CD2_BENIGN_MOUTH_PHARYNX	Benign neoplasm of mouth and pharynx
CD2_BENIGN_MOUTH_PHARYNX_EXALLC	Benign neoplasm of mouth and pharynx (all cancers excluded)
CD2_BENIGN_NASOPHARYNX	Benign neoplasm: Nasopharynx
CD2_BENIGN_NASOPHARYNX_EXALLC	Benign neoplasm: Nasopharynx (all cancers excluded)
CD2_BENIGN_NOS	Benign neoplasm: Other/unspecified site
CD2_BENIGN_NOS_EXALLC	Benign neoplasm: Other/unspecified site (all cancers excluded)
CD2_BENIGN_OESOPHAGUS	Benign neoplasm: Oesophagus
CD2_BENIGN_OESOPHAGUS_EXALLC	Benign neoplasm: Oesophagus (all cancers excluded)
CD2_BENIGN_OROPHA_OTHER	Benign neoplasm: Other parts of oropharynx
CD2_BENIGN_OROPHA_OTHER_EXALLC	Benign neoplasm: Other parts of oropharynx (all cancers excluded)
CD2_BENIGN_OTHERDIGESTIVE	Benign neoplasm of other and ill-defined parts of digestive system
CD2_BENIGN_OTHERDIGESTIVE_EXALLC	Benign neoplasm of other and ill-defined parts of digestive system (all cancers excluded)
CD2_BENIGN_OTHER_NOS	Benign neoplasm of other and unspecified sites
CD2_BENIGN_OTHER_NOS_EXALLC	Benign neoplasm of other and unspecified sites (all cancers excluded)
CD2_BENIGN_OVARY	Benign neoplasm of ovary
CD2_BENIGN_OVARY_EXALLC	Benign neoplasm of ovary (all cancers excluded)
CD2_BENIGN_PANCREAS	Benign neoplasm: Pancreas
CD2_BENIGN_PANCREAS_EXALLC	Benign neoplasm: Pancreas (all cancers excluded)
CD2_BENIGN_PARATHYROID	Benign neoplasm: Parathyroid gland
CD2_BENIGN_PARATHYROID_EXALLC	Benign neoplasm: Parathyroid gland (all cancers excluded)
CD2_BENIGN_PAROTID	Benign neoplasm: Parotid gland
CD2_BENIGN_PAROTID_EXALLC	Benign neoplasm: Parotid gland (all cancers excluded)
CD2_BENIGN_PERIPH_AUTO_NEURO	Benign neoplasm: Peripheral nerves and autonomic nervous system
CD2_BENIGN_PERIPH_AUTO_NEURO_EXALLC	Benign neoplasm: Peripheral nerves and autonomic nervous system (all cancers excluded)
CD2_BENIGN_PHARYNX_NOS	"Benign neoplasm: Pharynx, unspecified"
CD2_BENIGN_PHARYNX_NOS_EXALLC	"Benign neoplasm: Pharynx, unspecified" (all cancers excluded)
CD2_BENIGN_PITUITARY_CRANIPHAR	"Benign neoplasm: Pituitary gland, craniopharyngeal duct"
CD2_BENIGN_PITUITARY_CRANIPHAR_EXALLC	"Benign neoplasm: Pituitary gland, craniopharyngeal duct" (all cancers excluded)
CD2_BENIGN_PROSTATE	Benign neoplasm: Prostate
CD2_BENIGN_PROSTATE_EXALLC	Benign neoplasm: Prostate (all cancers excluded)
CD2_BENIGN_RECTOSIGMOID_JUNC	Benign neoplasm: Rectosigmoid junction
CD2_BENIGN_RECTOSIGMOID_JUNC_EXALLC	Benign neoplasm: Rectosigmoid junction (all cancers excluded)
CD2_BENIGN_RECTUM	Benign neoplasm: Rectum
CD2_BENIGN_RECTUM_ANAL	"Benign neoplasm: Rectum, anus and anal canal"
CD2_BENIGN_RECTUM_ANAL_CANAL_ICD9	Benign neoplasm: Rectum/anal canal icd-9
CD2_BENIGN_RECTUM_ANAL_CANAL_ICD9_EXALLC	Benign neoplasm: Rectum/anal canal icd-9 (all cancers excluded)
CD2_BENIGN_RECTUM_ANAL_EXALLC	"Benign neoplasm: Rectum, anus and anal canal" (all cancers excluded)
CD2_BENIGN_RECTUM_EXALLC	Benign neoplasm: Rectum (all cancers excluded)
CD2_BENIGN_SALIVARY	Benign neoplasm of major salivary glands
CD2_BENIGN_SALIVARY_EXALLC	Benign neoplasm of major salivary glands (all cancers excluded)
CD2_BENIGN_SALIVARY_NOS	Benign neoplasm: other/unspecified salivary gland
CD2_BENIGN_SALIVARY_NOS_EXALLC	Benign neoplasm: other/unspecified salivary gland (all cancers excluded)
CD2_BENIGN_SIGMOID_COLON	Benign neoplasm: Sigmoid colon
CD2_BENIGN_SIGMOID_COLON_EXALLC	Benign neoplasm: Sigmoid colon (all cancers excluded)
CD2_BENIGN_SKIN	Other benign neoplasms of skin
CD2_BENIGN_SKIN_EAR	Benign neoplasm: Skin of ear and external auricular canal
CD2_BENIGN_SKIN_EAR_EXALLC	Benign neoplasm: Skin of ear and external auricular canal (all cancers excluded)
CD2_BENIGN_SKIN_EXALLC	Other benign neoplasms of skin (all cancers excluded)
CD2_BENIGN_SKIN_EYELID	"Benign neoplasm: Skin of eyelid, including canthus"
CD2_BENIGN_SKIN_EYELID_EXALLC	"Benign neoplasm: Skin of eyelid, including canthus" (all cancers excluded)
CD2_BENIGN_SKIN_FACE	Benign neoplasm: Skin of other and unspecified parts of face
CD2_BENIGN_SKIN_FACE_EXALLC	Benign neoplasm: Skin of other and unspecified parts of face (all cancers excluded)
CD2_BENIGN_SKIN_LIP	Benign neoplasm: Skin of lip
CD2_BENIGN_SKIN_LIP_EXALLC	Benign neoplasm: Skin of lip (all cancers excluded)
CD2_BENIGN_SKIN_LOWERLIMB	"Benign neoplasm: Skin of lower limb, including hip"
CD2_BENIGN_SKIN_LOWERLIMB_EXALLC	"Benign neoplasm: Skin of lower limb, including hip" (all cancers excluded)
CD2_BENIGN_SKIN_NOS	"Benign neoplasm: Skin, unspecified"
CD2_BENIGN_SKIN_NOS_EXALLC	"Benign neoplasm: Skin, unspecified" (all cancers excluded)
CD2_BENIGN_SKIN_SCALPNECK	Benign neoplasm: Skin of scalp and neck
CD2_BENIGN_SKIN_SCALPNECK_EXALLC	Benign neoplasm: Skin of scalp and neck (all cancers excluded)
CD2_BENIGN_SKIN_TRUNK	Benign neoplasm: Skin of trunk
CD2_BENIGN_SKIN_TRUNK_EXALLC	Benign neoplasm: Skin of trunk (all cancers excluded)
CD2_BENIGN_SKIN_UPPERLIMB	"Benign neoplasm: Skin of upper limb, including shoulder"
CD2_BENIGN_SKIN_UPPERLIMB_EXALLC	"Benign neoplasm: Skin of upper limb, including shoulder" (all cancers excluded)
CD2_BENIGN_SMALL_INTESTINE	Benign neoplasm: Small intestine
CD2_BENIGN_SMALL_INTESTINE_EXALLC	Benign neoplasm: Small intestine (all cancers excluded)
CD2_BENIGN_SMALL_INTESTINE_OTH	Benign neoplasm: Other and unspecified parts of small intestine
CD2_BENIGN_SMALL_INTESTINE_OTH_EXALLC	Benign neoplasm: Other and unspecified parts of small intestine (all cancers excluded)
CD2_BENIGN_SPINAL_CORD	Benign neoplasm: Spinal cord
CD2_BENIGN_SPINAL_CORD_EXALLC	Benign neoplasm: Spinal cord (all cancers excluded)
CD2_BENIGN_STOMACH	Benign neoplasm: Stomach
CD2_BENIGN_STOMACH_EXALLC	Benign neoplasm: Stomach (all cancers excluded)
CD2_BENIGN_THYROID	Benign neoplasm of thyroid gland
CD2_BENIGN_THYROID_EXALLC	Benign neoplasm of thyroid gland (all cancers excluded)
CD2_BENIGN_TONGUE	Benign neoplasm: Tongue
CD2_BENIGN_TONGUE_EXALLC	Benign neoplasm: Tongue (all cancers excluded)
CD2_BENIGN_TONSIL	Benign neoplasm: Tonsil
CD2_BENIGN_TONSIL_EXALLC	Benign neoplasm: Tonsil (all cancers excluded)
CD2_BENIGN_TRANSVERSE_COLON	Benign neoplasm: Transverse colon
CD2_BENIGN_TRANSVERSE_COLON_EXALLC	Benign neoplasm: Transverse colon (all cancers excluded)
CD2_BENIGN_URINARY	Benign neoplasm of urinary organs
CD2_BENIGN_URINARY_EXALLC	Benign neoplasm of urinary organs (all cancers excluded)
CD2_BENIGN_UTERINE_TUBES_LIGAMENTS	Benign neoplasm: Uterine tubes and ligaments
CD2_BENIGN_UTERINE_TUBES_LIGAMENTS_EXALLC	Benign neoplasm: Uterine tubes and ligaments (all cancers excluded)
CD2_BENIGN_UTERUS_NOS	Other benign neoplasm of uterus: Other parts/unspecified
CD2_BENIGN_UTERUS_NOS_EXALLC	Other benign neoplasm of uterus: Other parts/unspecified (all cancers excluded)
CD2_BENIGN_UTERUS_OTH	Other benign neoplasms of uterus
CD2_BENIGN_UTERUS_OTH_EXALLC	Other benign neoplasms of uterus (all cancers excluded)
CD2_BENIGN_VAGINA	Benign neoplasm: Vulva
CD2_BENIGN_VAGINA_EXALLC	Benign neoplasm: Vulva (all cancers excluded)
CD2_BENIGN_VULVA	Benign neoplasm: Vagina
CD2_BENIGN_VULVA_EXALLC	Benign neoplasm: Vagina (all cancers excluded)
CD2_FOLLICULAR_LYMPHOMA	Follicular lymphoma
CD2_FOLLICULAR_LYMPHOMA_EXALLC	Follicular lymphoma (all cancers excluded)
CD2_HODGKIN_LYMPHOMA	Hodgkin lymphoma
CD2_HODGKIN_LYMPHOMA_EXALLC	Hodgkin lymphoma (all cancers excluded)
CD2_IMMUNOPROLIFERATIVE	Malignant immunoproliferative diseases
CD2_IMMUNOPROLIFERATIVE_EXALLC	Malignant immunoproliferative diseases (all cancers excluded)
CD2_INSITU	In situ neoplasms
CD2_INSITU_BREAST	Carcinoma in situ of breast
CD2_INSITU_BREAST_EXALLC	Carcinoma in situ of breast (all cancers excluded)
CD2_INSITU_BREAST_INTRADUCTAL	"Carcinoma in situ of breast, intraductal"
CD2_INSITU_BREAST_INTRADUCTAL_EXALLC	"Carcinoma in situ of breast, intraductal" (all cancers excluded)
CD2_INSITU_BREAST_NOS	"Carcinoma in situ of breast, other/unspecified"
CD2_INSITU_BREAST_NOS_EXALLC	"Carcinoma in situ of breast, other/unspecified" (all cancers excluded)
CD2_INSITU_CERVIX_UTERI	Carcinoma in situ of cervix uteri
CD2_INSITU_CERVIX_UTERI_ENDOCERVIX	"Carcinoma in situ of cervix uteri, endocervix"
CD2_INSITU_CERVIX_UTERI_ENDOCERVIX_EXALLC	"Carcinoma in situ of cervix uteri, endocervix" (all cancers excluded)
CD2_INSITU_CERVIX_UTERI_EXALLC	Carcinoma in situ of cervix uteri (all cancers excluded)
CD2_INSITU_CERVIX_UTERI_EXOCERVIX	"Carcinoma in situ of cervix uteri, exocervix"
CD2_INSITU_CERVIX_UTERI_EXOCERVIX_EXALLC	"Carcinoma in situ of cervix uteri, exocervix" (all cancers excluded)
CD2_INSITU_CERVIX_UTERI_NOS	"Carcinoma in situ of uteri, other/unspecified"
CD2_INSITU_CERVIX_UTERI_NOS_EXALLC	"Carcinoma in situ of uteri, other/unspecified" (all cancers excluded)
CD2_INSITU_EXALLC	In situ neoplasms (all cancers excluded)
CD2_INSITU_GENITAL	Carcinoma in situ of other and unspecified genital organs
CD2_INSITU_GENITAL_EXALLC	Carcinoma in situ of other and unspecified genital organs (all cancers excluded)
CD2_INSITU_MELANOMA	Melanoma in situ
CD2_INSITU_MELANOMA_EXALLC	Melanoma in situ (all cancers excluded)
CD2_INSITU_MELANOMA_FACE	Melanoma in situ of other and unspecified parts of face
CD2_INSITU_MELANOMA_FACE_EXALLC	Melanoma in situ of other and unspecified parts of face (all cancers excluded)
CD2_INSITU_MELANOMA_TRUNK	Melanoma in situ of trunk
CD2_INSITU_MELANOMA_TRUNK_EXALLC	Melanoma in situ of trunk (all cancers excluded)
CD2_INSITU_SKIN	Carcinoma in situ of skin
CD2_INSITU_SKIN_EAR	Carcinoma in situ of skin of ear and external auricular canal
CD2_INSITU_SKIN_EAR_EXALLC	Carcinoma in situ of skin of ear and external auricular canal (all cancers excluded)
CD2_INSITU_SKIN_EXALLC	Carcinoma in situ of skin (all cancers excluded)
CD2_INSITU_SKIN_FACE	Carcinoma in situ of skin of other and unspecified parts of face
CD2_INSITU_SKIN_FACE_EXALLC	Carcinoma in situ of skin of other and unspecified parts of face (all cancers excluded)
CD2_INSITU_SKIN_LOWERLIMB	"Carcinoma in situ of skin of lower limb, including hip"
CD2_INSITU_SKIN_LOWERLIMB_EXALLC	"Carcinoma in situ of skin of lower limb, including hip" (all cancers excluded)
CD2_INSITU_SKIN_NOS	"Carcinoma in situ of skin, other sites/unspecified"
CD2_INSITU_SKIN_NOS_EXALLC	"Carcinoma in situ of skin, other sites/unspecified" (all cancers excluded)
CD2_INSITU_SKIN_SCALPNECK	Carcinoma in situ of skin of scalp and neck
CD2_INSITU_SKIN_SCALPNECK_EXALLC	Carcinoma in situ of skin of scalp and neck (all cancers excluded)
CD2_INSITU_SKIN_TRUNK	Carcinoma in situ of skin of trunk
CD2_INSITU_SKIN_TRUNK_EXALLC	Carcinoma in situ of skin of trunk (all cancers excluded)
CD2_INSITU_SKIN_UPPERLIMB	"Carcinoma in situ of skin of upper limb, including shoulder"
CD2_INSITU_SKIN_UPPERLIMB_EXALLC	"Carcinoma in situ of skin of upper limb, including shoulder" (all cancers excluded)
CD2_LEUKAEMIA_NAS	Leukaemia of unspecified cell type
CD2_LEUKAEMIA_NAS_EXALLC	Leukaemia of unspecified cell type (all cancers excluded)
CD2_LYMPHOID_LEUKAEMIA	Lymphoid leukaemia
CD2_LYMPHOID_LEUKAEMIA_EXALLC	Lymphoid leukaemia (all cancers excluded)
CD2_MULTIPLE_MYELOMA_PLASMA_CELL	Multiple myeloma and malignant plasma cell neoplasms
CD2_MULTIPLE_MYELOMA_PLASMA_CELL_EXALLC	Multiple myeloma and malignant plasma cell neoplasms (all cancers excluded)
CD2_MYELOID_LEUKAEMIA	Myeloid leukaemia
CD2_MYELOID_LEUKAEMIA_EXALLC	Myeloid leukaemia (all cancers excluded)
CD2_NONFOLLICULAR_LYMPHOMA	Non-follicular lymphoma
CD2_NONFOLLICULAR_LYMPHOMA_EXALLC	Non-follicular lymphoma (all cancers excluded)
CD2_NONHODGKIN_NAS	Other and unspecified types of non-Hodgkin lymphoma
CD2_NONHODGKIN_NAS_EXALLC	Other and unspecified types of non-Hodgkin lymphoma (all cancers excluded)
CD2_PRIMARY_LYMPHOID_HEMATOPOIETIC	Primary_lymphoid and hematopoietic malignant neoplasms
CD2_PRIMARY_LYMPHOID_HEMATOPOIETIC_EXALLC	Primary_lymphoid and hematopoietic malignant neoplasms (all cancers excluded)
CD2_PRIMARY_LYMPHOID_HEMATOPOIETIC_NAS	"Other and unspecified malignant neoplasms of lymphoid, haematopoietic and related tissue"
CD2_PRIMARY_LYMPHOID_HEMATOPOIETIC_NAS_EXALLC	"Other and unspecified malignant neoplasms of lymphoid, haematopoietic and related tissue" (all cancers excluded)
CD2_TNK_LYMPHOMA	Mature T/NK-cell lymphomas
CD2_TNK_LYMPHOMA_EXALLC	Mature T/NK-cell lymphomas (all cancers excluded)
CHARCOT	Charcot foot
CHILDHOOD_ALLERGY	Childhood allergy (age < 16)
CHIRBIL_PRIM	"Biliary chirrosis, primary"
CHIRHEP_NAS	"Chirrosis of liver, NAS"
CHOLELITH_BROAD	"Cholelithiasis, broad definition with cholecystitis"
CHONDRO_OTH	Other chondrocalcinosis
CHRONHEP_NAS	Chronic hepatitis NAS
CHRONLARGE	Crohn's disease of large intestine
CHRONMYELOPRO	Chronic myeloproliferative disease
CHRONNAS	Chron's disease NAS
CHRONOTH	Other Chron's disease
CHRONSMALL	Crohn's disease of small interstine
CIRRHOSIS_BROAD	"Cirrhosis, broad definition used in the article https://doi.org/10.1101/594523"
CML	"Chronic myeloid leukaemia [CML], BCR/ABL-positive"
CMV_NOS	Other/unspecified cytomegaloviral diseases
COLITALLERG	Allergic colitis
COLITCOLLAG	Collagenous colitis
COLITENTER	Pseudomembranous colitis
COLITNONINFNAS	Noninfectious colitis NAS
COLITRAD	Colitis due to radiation
CONGEN_HEART_ARTER	Congenital malformations of heart and great arteries
COPD_ASTHMA_INFECTIONS	COPD/asthma related infections
COPD_ASTHMA_PNEUMONIA_SEPSIS	COPD/asthma related pneumonia or pneumonia derived septichaemia
COPD_COMORB	COPD-associated co-morbidities
COPD_CVDMETABOCOMORB	"COPD Co-morbidites, CVD and metabolic diseases"
COPD_EARLY	Early onset COPD
COPD_EARLYANDLATER	"COPD, early/later onset"
COPD_EXCL	COPD differential diagnosis
COPD_HOSPITAL	"COPD, hospital admissions"
COPD_HOSPITAL_ASTHMA_INF	"COPD, hospital admission 2, with asthma infections"
COPD_HOSPITAL_ASTHMA_PNEUM_SEPSIS	"COPD, hospital admissions 3, with asthma pneumonia sepsis"
COPD_HOSPITAL_MAIN	"COPD, hospital admissions 1, only main diagnosis"
COPD_INSUFFICIENCY	COPD-related respiratory insufficiency
COPD_LATER	Later onset COPD
COPD_MODE	COPD (mode)
COPD_MULTIMORB	COPD related to multimorbidity
COPD_OPPORTUNIST_INFECTIONS	COPD related to chronic (opportunist) infections
COX_ARTHROSIS	Coxarthrosis [arthrosis of hip](FG)
CPAP	Continuous positive airway pressure
CREST	CR(E)ST syndrome
CROHN_ARTHR	Arthropathy in Crohn disease
C_DIFFICILE_ENTEROCOLITIS	Enterocolitis due to Clostridium difficile
C_PSOR_ARTHR_COMORB	Psoriatic arthropathies related co-morbidities
C_STROKE	STROKE
D1_ICD8	ICD-8 DM (Sub-endpoint used for defining DM endpoints)
D3_ACQHAEMOLYTICANAEMIA	Acquired haemolytic anaemia
D3_ACQHAEMOLYTICANAEMIANAS	Other and unspecified acquired haemolytic anaemias
D3_ACUTEPOSTBLEEDANAEMIA	Acute posthaemorrhagic anaemia
D3_AGRANULOCYTOSIS	Agranulocytosis
D3_AIHA_OTHER	Other autoimmune haemolytic anaemias
D3_ALLERGPURPURA	Allergic purpura
D3_ANAEMIA	Anaemias
D3_ANAEMIAINCHRONICDISEASE	Anaemia in chronic diseases classified elsewhere
D3_ANAEMIANAS	Other and unspecified anaemias
D3_ANAEMIA_B12_DEF	Vitamin B12 deficiency anaemia
D3_ANAEMIA_IRONDEF	Iron deficiency anaemia
D3_ANAEMIA_IRONDEF_BLOODLOSS	Iron deficiency anaemia secondary to blood loss (chronic)
D3_ANAEMIA_IRONDEF_NAS	Other and unspecified iron deficiency
D3_APLASTICANDOTHANAEMIA	Aplastic and other anaemias
D3_BLOOD	Diseases of the blood and blood-forming organs and certain disorders involving the immune mechanism
D3_BLOODNAS	Other and unspecified diseases of blood and blood-forming organs
D3_BLOODOTHER	Other diseases of blood and blood-forming organs
D3_COAGDEF	Chronic Coagulation defects
D3_COAGDEFNAS	Other and unspecified coagulation defects
D3_COAGDEF_PURPUR_HAEMORRHAGIC	"Coagulation defects, purpura and other haemorrhagic conditions"
D3_COAGOTHER	Other coagulation defects
D3_COMBIMMUDEF	Combined immunodeficiencies
D3_CVID	Common variable immunodeficiency
D3_DEF_IGG	Selective deficiency of immunoglobulin G [IgG] subclasses
D3_EOSINOPHILIA	Eosinophilia
D3_HAEMOLYTICANAEMIA	Haemolytic anaemias
D3_HAEMORRHAGCIRGUANTICO	Haemorrhagic disorder due to circulating anticoagulants
D3_HAEMORRHAGICNAS	Otherand unspecified haemorrhagic conditions
D3_HEREDOTHCLOFACTORS	Hereditary deficiency of other clotting factors
D3_IMMUDEF	Immunodeficiencies
D3_IMMUDEFANTIBODY	Immunodeficiency with predominantly antibody defects
D3_IMMUDEFANTIBODYNAS	Other and unspecified immunodeficiencies with predominantly antibody defects
D3_IMMUDEFOTHER	Other immunodeficiencies
D3_IMMUNEMECHANISM	Certain disorders involving the immune mechanism
D3_IMMUNEMECHANISMNAS	"Other and unspecified disorders involving the immune mechanism, not elsewhere classified"
D3_IMMUNEMECHANISMOTHER	"Other disorders involving the immune mechanism, not elsewhere classified"
D3_ITP	Idiopathic thrombocytopenic purpura
D3_KELA_IMMUDEF	Kela reimbursement Agammaglobulinemia (D80-84)
D3_NONHEREDHYPOGAMMA	Nonhereditary hypogammaglobulinemia
D3_NUTRIANAEMIA	Nutritional anaemias
D3_NUTRIANAEMIAOTHER	Other nutritional anaemias
D3_OTHERANAEMIA	Other anaemias
D3_OTHERAPLASTICANAEMIA	Other and unspecified aplastic anaemias
D3_OTHERBLOOD	Oher diseases of blood and blood-forming organs
D3_OTHERWHITECELL	Other disorders of white blood cells
D3_OTHNONTHROMBOCYTOPENPURPURA	Other nonthrombocytopenic purpura
D3_PURPURA_AND3_OTHER_HAEMORRHAGIC	Purpura and other haemorrhagic conditions
D3_SARCOIDOSIS	Sarcoidosis
D3_SCNDPOLYCYTHAEMIA	Secondary polycythaemia
D3_SCNDTHROMBOCYTOPENIA	Secondary thrombocytopenia
D3_SPLEENDISEASE	Diseases of spleen
D3_THROMBOCYTOPENIANAS	"Thrombocytopenia, unspecified"
D3_VONVILLEBRAND	Von Willebrand disease
D3_WHITEBLOODCELLNAS	Other and unspecified disorders of white blood cells
DEATH	Any death
DENTAL_TMD	TMD related pain
DENTAL_TMD_FIBRO	TMD muscular pain lnked with fibromyalgia
DERMATOPOLY_FG	Dermatopolymyositis (FG)
DIABETES_FG	"Diabetes, varying definitions"
DIAB_MED	Diabetes medication
DIAB_MED_OTHER	Other (not insulin) diabetes medications
DIALYSIS	Dialysis
DIS_THYROID_OTH	Other disorders of thyroid
DM_AION	AION (anterior ischemic optic neuropathy)
DM_BCKGRND_RETINA	Background diabetic retinopathy
DM_BCKGRND_RETINA_NONPROLIF	Severe non-proliferative background diabetic retinopathy
DM_COMORB	Diabetes-related co-morbidities/complications
DM_COMORB_EXMORE	Diabetes-related co-morbidities/complications (more controls excluded)
DM_DIALYSIS	"Diabetes, dialysis"
DM_EYE_OEPR_RETINAL_PHOTOCOAGULATION	Retinal photocoagulation
DM_EYE_OPER	"Operations, diabetic retinopathy"
DM_EYE_OPER_COMB_LENS_VITR	Combined lens and vitreous operation
DM_EYE_OPER_FOR_NON_DIAB_EXCLUSION	Exclude non-diabetic causes for injection of anti-VEGF-antibody or corticosteroid or any drug into vitreous body
DM_EYE_OPER_INJECT_AIRGAS_VITR	Injection of air or gas into the vitreous cavity
DM_EYE_OPER_INJECT_GEL_VITR	Injection of e.g. viscoelastic gel into the vitreous cavity
DM_EYE_OPER_REMOVAL_VITR	Removal of vitreous substitute
DM_EYE_OPER_REMOVAL_VITR_VIAPARSPLIC	Removal of vitreous/Extensive procedure in removing vitreous via pars plana/pars plicata
DM_EYE_OPER_VEGF_INJECT_VITR	Injection of anti-VEGF-antibody or corticosteroid or any drug into vitreous body
DM_EYE_OPER_VITR_RETINA_COMB	Combined vitreous and retina operation
DM_HYPOGLYC	Diabetic hypoglycemia
DM_IBD	"Diabetes 1 & 2, IBD co-morbidity"
DM_KETOACIDOSIS	Diabetic ketoacidosis
DM_KIDNEYFAIL	"Diabetes, kidney failure"
DM_KIDNEYTRANSPLANT	"Kidney transplantation, related to diabetes"
DM_MACULOPATHY	Diabetic maculopathy
DM_MACULOPATHY_EXMORE	Diabetic maculopathy (more controls excluded)
DM_NEOVASCULAR_GLAUCOMA	Neovascular glaucoma
DM_NEPHORAPATHY_OPER	Diabetic nephropathy with related operations
DM_NEPHROPATHY	Diabetic nephropathy
DM_NEPHROPATHY_EXMORE	Diabetic nephropathy (more controls excluded)
DM_NEUROPATHY	Diabetic neuropathy
DM_OPTHALMIC_COMORB	"Diabetes, opthalmic co-morbidities"
DM_OTHER_WIDE	"Other diabetes, wide definition"
DM_PERIPHATHERO	Peripheral atherosclerosis
DM_PERIPH_ANGIOPATHY	Peripheral angiopathy
DM_POLYNEURO	Diabetic polyneuropathy
DM_RETINA_NOS	Unspecified diabetic retinopathy
DM_RETINA_PROLIF	Proliferative diabetic retinopathy
DM_RETINA_PROLIF_NOS_ET_OPER	Proliferative diabetic retinopathy (Unspecified diabetic retinopathy + operation)
DM_RETINOPATHY	Diabetic retinopathy
DM_RETINOPATHY_EXMORE	Diabetic retinopathy (more controls excluded)
DM_RET_ART_OCCLU_BRANCH	Retinal artery occlusion (branch)
DM_RET_VEIN_OCCLU	Retinal vein occlusion (central or branch)
DM_SEVERAL_COMPLICATIONS	"Diabetes, several complications"
DM_VITREOUS_BLEEDING	Vitreous bleeding (caused by prolif. dmrp when together with H36.03*)
DRUGADVERS_ADRENOCORTICAL_INSUFFICIENCY	Drug-induced adrenocortical insufficiency
DRUGADVERS_CATAR	Drug-induced cataract
DRUGADVERS_NEUTROPENIA	Drug-induced neutropenia
DRUGADVERS_OSTEOPO	Drug-induced osteoporosis
DRUGADVERS_SYSTEMIC_LUPUS_ERYTHEMAT	Drug-induced systemic lupus erythematosus
DRUGADVERS_TREMOR	Drug-induced tremor
DRY_AMD	Dry age-related macular degeneration (includes geographic atrophy)
E4_ACIDOSIS	Acidosis
E4_ACROMEG	Acromegaly and pituitary gigantism
E4_ADDISON	Adrenocortical insufficiency
E4_ADRENAL	Other disorders of adrenal gland
E4_AMYLNAS	"Amyloidosis, other/unspecified"
E4_AMYLOIDOSIS	Amyloidosis
E4_CARCISDR	Carcinoid syndrome
E4_CA_MET	Disorders of calcium metabolism
E4_CONGEIOD	Congenital iodine-deficiency syndrome/hypothyroidism
E4_CUSHING	Cushing syndrome
E4_DELPUB	Delayed puberty
E4_DIABETES	Diabetes mellitus
E4_DIABINSIPIDUS	Diabetes insipidus
E4_DISPUB	Disorders of puberty
E4_DM1	Type 1 diabetes
E4_DM1COMA	Type 1 diabetes with coma
E4_DM1KETO	Type 1 diabetes with ketoacidosis
E4_DM1NASCOMP	Type 1 diabetes with other specified/multiple/unspecified complications
E4_DM1NEU	Type 1 diabetes with neurological complications
E4_DM1NOCOMP	Type 1 diabetes without complications
E4_DM1OPTH	Type 1 diabetes with ophthalmic complications
E4_DM1PERIPH	Type 1 diabetes with peripheral circulatory complications
E4_DM1REN	Type 1 diabetes with renal complications
E4_DM1_STRICT	"Type 1 diabetes, strict (exclude DM2)"
E4_DM2	Type 2 diabetes
E4_DM2COMA	Type 2 diabetes with coma
E4_DM2KETO	Type 2 diabetes with ketoacidosis
E4_DM2NASCOMP	Type 2 diabetes with other specified/multiple/unspecified complications
E4_DM2NEU	Type 2 diabetes with neurological complications
E4_DM2NOCOMP	Type 2 diabetes without complications
E4_DM2OPTH	Type 2 diabetes with ophthalmic complications
E4_DM2PERIPH	Type 2 diabetes with peripheral circulatory complications
E4_DM2REN	Type 2 diabetes with renal complications
E4_DM2_STRICT	"Type 2 diabetes, strict (exclude DM1)"
E4_DMICD8	"Diabetes, unspecified because of ICD-8"
E4_DMNAS	Unspecified diabetes
E4_DMNASKETO	Unspecified diabetes with ketoacidosis
E4_DMNASNASCOMP	Unspecified diabetes with multiple/unspecified complications
E4_DMNASNOCOMP	Unspecified diabetes without complications
E4_ENDODIS	Other endocrine disorders
E4_ENDODISNAS	"Endocrine disorders, other/unspecified"
E4_ENDOGLAND	Disorders of other endocrine glands
E4_ENDOMETPOSTOP	"Postprocedural endocrine and metabolic disorders, not elsewhere classified"
E4_ENDONUTRMET	"Endocrine, nutritional and metabolic diseases"
E4_FLUIDELECTRO	"Other disorders of fluid, electrolyte and acid-base balance"
E4_FLUIDELECTRONAS	"Other disorders of electrolyte and fluid balance, not elsewhere classified"
E4_GILBERT	Gilbert syndrome
E4_GLUCOPANCREAS	Other disorders of glucose regulation and pancreatic internal secretion
E4_GOITREDIFF	Nontoxic diffuse goitre
E4_GOITREMULTINOD	Nontoxic multinodular goitre
E4_GOITRENAS	Other and/or unspecified nontoxic goitre
E4_GOITRENOD	Nontoxic single thyroid nodule
E4_HYPERALDO	Hyperaldosteronism
E4_HYPERCHOL	Pure hypercholesterolaemia
E4_HYPERGLYCER	Pure hyperglyceridaemia
E4_HYPERKALAEMIA	Hyperkalaemia
E4_HYPERLIPMIX	Mixed hyperlipidaemia
E4_HYPERLIPNAS	"Hyperlipidaemia, other/unspecified"
E4_HYPEROSMHNAT	Hyperosmolality and hypernatraemia
E4_HYPERPARA	Hyperparathyroidism
E4_HYPERPIT	Hyperfunction of pituitary gland
E4_HYPERPRO	Hyperprolactinaemia
E4_HYPERPRO_ADVERSE	"Hyperprolactinaemia, drug-induced"
E4_HYPODRUG	Drug-induced hypoglycaemia without coma
E4_HYPOGLYC	"Hypoglycaemia, other or unspecified"
E4_HYPOKALAEMIA	Hypokalaemia
E4_HYPOOSMNAT	Hypo-osmolality and hyponatraemia
E4_HYPOPARA	Hypoparathyroidism
E4_HYPOPIT	Hypopituitarism
E4_HYTHYNAS	"Hypothyroidism,  other/unspecified"
E4_HYTHYPOSTINF	Postinfectious hypothyroidism
E4_HYTHYSUBS	Hypothyroidism due to medicaments and other exogenous substances
E4_HYTHY_AI_STRICT	"Hypothyroidism, strict autoimmune"
E4_HYTHY_AI_STRICT_PURCH	"Hypothyroidism, strict autoimmune, 3 medication purchases required"
E4_IRON_MET	Disorders of iron metabolism
E4_LACTONAS	"Lactose intolerance, other/unspecified"
E4_LACTOSEINT	Lactose intolerance
E4_LIPOPROT	Disorders of lipoprotein metabolism and other lipidaemias
E4_LIPOPROTNAS	"Disorder of lipoprotein metabolism, unspecified"
E4_MALNUTRITION	Malnutrition
E4_METABO	Other metabolic disorders
E4_METABOLIA	Metabolic disorders
E4_MINERAL_MET	Disorders of mineral metabolism
E4_NUTRIDEF	Other nutritional deficiencies
E4_NUTRI_DEF_NAS	Other specified/unspecified nutritional deficiencies
E4_OBESITY	Obesity
E4_OBESITYCAL	Obesity due to excess calories
E4_OBESITYDRUG	Drug-induced obesity
E4_OBESITYNAS	"Obesity, other/unspecified"
E4_OBESITYXTRMALV	Extreme obesity with alveolar hypoventilation
E4_OBESITY_HYPER	Obesity and other hyperalimentation
E4_OVARDYS	Ovarian dysfunction
E4_OVARFAIL	Primary ovarian failure
E4_PANCSECNAS	"Disorder of pancreatic internal secretion, other and/or unspecified"
E4_PARANAS	"Disorders of parathyroid gland, other and/or unspecified"
E4_PARATHYRO	Disorders of parathyroid gland
E4_PITUDISNAS	"Disorders of pituitary gland, other and/or unspecified"
E4_PLASMAPROT	"Disorders of plasma-protein metabolism, not elsewhere classified"
E4_POCS	Polycystic ovarian syndrome
E4_PORBILIR	Disorders of porphyrin and bilirubin metabolism
E4_SHORT	"Short stature, not elsewhere classified"
E4_TESTICHYPO	Testicular hypofunction
E4_TESTIDYS	Testicular dysfunction
E4_THYROID	Disorders of the thyroid gland
E4_THYROIDITAUTOIM	Autoimmune thyroiditis
E4_THYROIDITNAS	"Thyroiditis, unspecified"
E4_THYROIDITSUBAC	Subacute thyroiditis
E4_THYROIDNASOTH	"Disorder of thyroid, unspecified"
E4_THYTOXGOITDIF	Thyrotoxicosis with diffuse goitre
E4_THYTOXGOITMULT	Thyrotoxicosis with toxic multinodular goitre
E4_THYTOXNAS	"Thyrotoxicosis, other and/or unspecified"
E4_THYTOXNOD	Thyrotoxicosis with toxic single thyroid nodule
E4_VIT_B_DEF	Deficiency of other B group vitamins
E4_VIT_DEF	Vitamin deficiency
E4_VIT_D_DEF	Vitamin D deficiency
E4_VOLUME	Volume depletion
ENCEPHALITIS	Encephalitis
EPISEIZALCO	Epileptic seizures related to alcohol
ERECTILE_DYSFUNCTION	Erectile dysfunction
ESOSINOPHIL_DISEASE	Eosinophilic disease (BM)
ETMOIDECTOMY	Etmoidectomy
F5_ADHD	Disturbance of activity and attention
F5_ALCOHOL	Mental and behavioural disorders due to alcohol
F5_ALCOHOLAC	Acute alcohol intoxication
F5_ALCOHOL_DEPENDENCE	Alcohol dependence
F5_ALLANXIOUS	All anxiety disorders
F5_ALZHDEMENT	Dementia in Alzheimer disease
F5_ANAPER	Anankastic personality disorder
F5_ANOREX	Anorexia (incl.atypical)
F5_ANXIETY	Other anxiety disorders
F5_ANXPER	Anxious personality disorder
F5_AUTISM	Autism
F5_BEHAVE	Behavioural syndromes associated with physiological disturbances and physical factors
F5_BEHEMOCHILD	Behauvioural and emotional disorders with onset usually occuring in childhood and adolescence
F5_BEHEMOTH	Other behavioural and emotional disorders with onset usually occuring in childhood and adolescence
F5_BIPO	Bipolar affective disorders
F5_BULIMIA	Bulimia nervosa (incl. atypical)
F5_CANNABIS	Mental and behavioural disorders due to cannabinoids
F5_CONDUCT	Conduct disorder
F5_CONDUCTEMO	Mixed disorders of conduct and emotions
F5_DELIRIUM	"Delirium, not induced by alcohol and other psychoactive substances"
F5_DELUSIO	Persistent delusional disorders
F5_DEMENTIA	Dementia
F5_DEMENTIA_INCLAVO	"Dementia, including avohilmo"
F5_DEMINOTH	Dementia in other diseases classified elsewhere
F5_DEMNAS	Unspecified dementia
F5_DEPPER	Dependent personality disorder
F5_DEPRESSIO	Depression
F5_DISPER	Dissocial personality disorder
F5_DISSOCIATIVE	Dissociative [conversion] disorders
F5_Dementia_U	Undefined dementia
F5_Dementia_U_EXMORE	Undefined dementia (more controls excluded)
F5_EATING	Eating disorders
F5_EATOTH	Other eating disorders
F5_EMOCHILD	Emotional disorders and disorders of social functioning with onset specific to childhood
F5_EMOPER	Emotionally unstable personality disorder
F5_GAD	Generalized anxiety disorder
F5_GENDER	Gender identity disorders
F5_HABIT	Habit and impulse disorders
F5_HALLUCIN	Mental and behavioural disorders due to hallucinogens
F5_HISPER	Histrionic personality disorder
F5_HYPERKIN	Hyperkinetic disorders (excl. ADHD)
F5_HYPERSOMNIA	Hypersomnia
F5_INSOMNIA	Insomnia
F5_KELAMENT	Kela-cod for severe mental illness
F5_KELARET	Kela-code for behavioural disturbances in mental retardation
F5_MANIA	Manic episode
F5_MENTALUNSPE	"Mental disorders, not otherwise specified"
F5_MENTORG	Other mental disorders due to brain damage and dysfunction and to physical disease
F5_MENTPUER	Mental and behauvioural disorders associated with the puerperium
F5_MENTRET	Mental retardation
F5_MILDRET	Mild mental retardation
F5_MIXEDDEV	Mixed specific developmental disorders
F5_MIXPER	Mixed and other personality disorders
F5_MODRET	Moderate mental retardation
F5_MOOD	Mood [affective] disorders
F5_MOODOTH	Other and unspecidied mood [affective] disorders
F5_MOTOR	Specific developmental disorder of motor function
F5_NEUROTIC	"Neurotic, stress-related and somatoform disorders"
F5_NEUROTICOTH	Other neurotic disorders
F5_OCD	Obsessive-compulsive disorder
F5_OPIOIDS	Mental and behavioural disorders due to opioids
F5_ORGANIC	"Organic, including symptomatic, mental disorders"
F5_OTHERSUB	Mental and behavioural disorders due to multiple drug use and use of multiple drugs and use of other psycoactive substances
F5_OTHPER	Other specified and unspecified personality disorders
F5_OTHRET	Other and unspecified mental retardation
F5_PANIC	Panic disorder
F5_PARAPER	Paranoid personality disorder
F5_PERSBEHORG	"Personality and behavioural disorders due to brain disease, damage and dysfunction"
F5_PERSMOOD	Persistent mood disorders
F5_PERSOBEH	Disorders of adult personality and behaviour
F5_PERSONALITY	Specific personality disorders
F5_PERSOTH	Other and unspecified disorders of adult personality and behauviour
F5_PERVASIVE	Pervasive developmental disorders excl. Autism + Asperger
F5_PHOBANX	Phobic anxiety disorders
F5_PHYSBEHOTH	Unspefcified behauvioural syndromes associated with physiological disturbances and physical factors +Phsyiological and behauvioural factors associated with disorders of diseases classified elsewhere
F5_PSYCH	Psychiatric diseases
F5_PSYCHDEV	Disorders of psychological developtment
F5_PSYCHDEVOTH	Other and unspecified disorders of psychological development
F5_PSYCHOTH	Other and unspecified nonorganic psychotic disorders
F5_PSYTRANS	Acute and transient psychotic disorders
F5_PTSD	Post-traumatic stress disorder
F5_SCHIZO	"Schizophrenia, schizotypal and delusional disorders"
F5_SCHIZOAFF	Schizoaffective disorder
F5_SCHIZOTYP	Schizotypal disorder
F5_SCHIZPER	Schizoid personality disorder
F5_SCHOLA	Specific development disorders of scholastic skills
F5_SCHZPHR	Schizophrenia
F5_SEDAHYP	Mental and behavioural disorders due to sedatives or hypnotics
F5_SEXDYS	Sexual dysfunction
F5_SLEEP	Sleep disorders
F5_SLEEPWAKE	Disorder of the sleep-wake schedule
F5_SLEEP_NOS	"Sleep disorders, other/unspeficied"
F5_SOMATOFORM	Somatoform disorder
F5_SPEECH	Specific development disorders of speech and language
F5_STIMUL	"Mental and behavioural disorders due to use of other stimulants, including caffeine"
F5_STRESSOTH	"Other reactioin to severe stress, and adjustment disorders"
F5_SUBSNOALCO	"Substance use, excluding alcohol"
F5_SUBSTANCE	Mental and behavioural disorders due to psychoctive substance use
F5_TIC	Tic disorders
F5_TOBAC	Mental and behavioural disorders due to tobacco
F5_UNSMENDIS	Unspecified mental disorder
F5_VASCDEM	Vascular dementia
FALLS	Falls/tendenct to fall
FE	Focal epilepsy
FEMHER_UNILATERAL	"Femoral hernia, unilateral"
FEMINGHER_BILATERAL	"Inguinal or femoral hernia, bilateral"
FEMNINGHER_UNILATERAL	"Inguinal of femoral hernia, unilateral"
FESS	FESS (DNB20)
FE_MODE	"Focal epilepsy, mode (most common among epilepsy diagnosis)"
FE_STRICT	"Focal epilepsy, strict definition"
FG_CARDMYO	Cardiomyopathy (excluding other)
FG_CEREBVASC	Cerebrovascular diseases (FINNGEN)
FG_CVD	Cardiovascular diseases (excluding rheumatic etc)
FG_DISVEINLYMPH	"Diseases of veins, lymphatic vessels and lymph nodes, not elsewhere classified (FINNGEN)"
FG_DOAAC	"Diseases of arteries, arterioles and capillaries (FINNGEN)"
FG_HYPERTENSION	Hypertensive diseases (excluding secondary)
FG_OTH	Other CVD (FINNGEN)
FG_OTHHEART	Other heart diseases
FG_PULMHEART	Pulmonary heart disease
FIBRO_COMORB	Fibromyalgia related co-morbidities
G6_AD_WIDE	"AlzheimerÕs disease, wide definition"
G6_AD_WIDE_EXMORE	"AlzheimerÕs disease, wide definition" (more controls excluded)
G6_ALCODEGEN	Degeneration of the brain due to alcohol
G6_ALCOPOLY	Alcohol induced polyneuropathy
G6_ALS	Motor neuron disease
G6_ALZHEIMER	Alzheimer disease
G6_ALZHEIMER_EXMORE	Alzheimer disease (more controls excluded)
G6_ALZHEIMER_INCLAVO	"Alzheimer disease, including avohilmo"
G6_ANOXBRAINDAM	Anoxic brain damage
G6_ATROPHCIRCUM	Circumscribed brain atrophy
G6_ATYFAC	Atypical facial pain
G6_AUTONOM	Autonomic disorders
G6_BASDEGENOTH	Other degenarative diseases of the basal ganglia
G6_BELLPA	Bell's palsy
G6_BENINTRAHYP	Benign intracranial hypertension
G6_BRACHPLE	Brachial plexus disorders
G6_CARPTU	Carpal tunnel syndrome
G6_CAUDA	Cauda equina syndrome
G6_CAUSALGIA	Causalgia
G6_CERCYST	Cerebral cysts
G6_CERVROOT	Cervical root disorders
G6_CNSABSC	Intracranial and intraspinal abscess and granuloma
G6_CNSOTH	Other disorders of central nervous system
G6_CP	Cerebral palsy
G6_CPETAL	Cerebral palsy and other paralytic syndromes
G6_DEGENOTH	Other and unspecified degenerative diseases of nervous system
G6_DEMYEL	Demyelenating diseases of the central nervous system
G6_DIABETNEUR	Diabethic neuropathy
G6_DISBROTHUNS	"Disorders of brain, other and unspecified"
G6_DISOTHUNS	Disorders of other and unspecified cranial nerves
G6_DISSOTH	Other acute disseminated demyelination
G6_DRUGPOLY	Drug-induced polyneuropathy
G6_DYSTON	Dystonia
G6_ENCEPATH	Encephalopathy
G6_ENCEPHOTH	Other encephalitis
G6_EPIPAROX	Episodal and paroxysmal disorders
G6_EPLEPSY	Epilepsy
G6_FACOTH	Other facial nerve disorders
G6_FEMLAPOP	Lesion of lateral popliteal nerve
G6_FEMLE	Lesion of femoral nerve
G6_GUILBAR	Guillain-Barre syndrome
G6_HCCOMM	Communicating hydrocephalus
G6_HCNP	Normal-pressure hydrocephalus
G6_HCOBSTR	Obstructive hydrocephalus
G6_HCOTHUNS	Other and unspecified hydrocephalus
G6_HEADACHE	Other headache syndromes
G6_HEMIPLE	Hemiplegia
G6_HERATAXIA	Hereditary ataxia
G6_HEREMOSEN	Hereditary monor and sensory neuropathy
G6_HORNER	Horner syndrome
G6_HYDROCEPH	Hydrocephalus
G6_ICNEUROP	Intercostal neuropathy
G6_LSROOT	"Lumbosacral root disorders, not elsewhere classified"
G6_MEDLEOTH	Other lesions of median nerve
G6_MENINGBACT	Bacterial meningitis
G6_MENINGOTH	Other meningitis
G6_MERALGIA	Meralgia paraesthetica
G6_MIGRAINE	Migraine
G6_MIGRAINE_NO_AURA	Migraine without aura
G6_MIGRAINE_NO_AURA_ADVERSE	"Migraine without aura, drug-induced"
G6_MIGRAINE_NO_AURA_TRIPTAN	Migraine without aura and triptan purchases
G6_MIGRAINE_WITH_AURA	Migraine with aura
G6_MIGRAINE_WITH_AURA_ADVERSE	"Migraine with aura, drug-induced"
G6_MIGRAINE_WITH_AURA_TRIPTAN	Migraine with aura and triptan purchases
G6_MONOLOWOTHUNS	Other and unspecified mononeuropathies of lower limb
G6_MONONPOTHUS	Other and unspecified mononeuropathies of upper limb
G6_MONOOTHUNS	"Other and unsepcified mononeuropathies, also in other diseases"
G6_MONOPLE	Monoplegia
G6_MS	MS-disease / Multiple Sclerosis
G6_MUSCOTHUNS	Other and unspecified primary disorders of muscles
G6_MUSDYST	Muscular dystrophy
G6_MYASTHENIA	Myasthenia gravis
G6_MYOMUSCINOTH	Disorders of myonerural junction and muscle in diseases in classifeid elsewhere
G6_MYONEU	Diseases of the myoneural junction and muscle
G6_MYOPOTHUNS	Other and unspecified myopathies
G6_MYOTDIS	Mytonic disorders
G6_NARCOCATA	Narcolepsy and cataplexy
G6_NERPLEX	"Nerve, nerve root and plexus disorders"
G6_NEUATR	Systemic atrophies primarly affecting the central nervous system
G6_NEUINFL	Inflammatory diseases of the central nervous system
G6_NEURO	Neurological diseases
G6_NEURODEG	Other degenerative diseases of the nervous system
G6_NEUROOTH	Other disorders of nervous system
G6_OTHDEMYEL	Other demyelinating diseases of the central nervous system
G6_OTHNEU	Other neurological diseases
G6_PARALOTHUNS	Other and unspecified paralytic syndromes
G6_PARDIPLE	"Paraplegia, diplegia of upper limbs"
G6_PARKINSON	Parkinson's disease
G6_PARKINSON_EXMORE	Parkinson's disease (more controls excluded)
G6_PARKINSON_INCLAVO	"Parkinson's disease, including avohilmo"
G6_PARKSCND	Secondary parkinsonism+Parkinsonism in other disease
G6_PLANTAR	Lesion of plantar nerve
G6_POLYNEU	Polyneuropathies and other disorders of the peripheral nervous system
G6_POLYOTHUNS	"Other and unspecified polyneuropathies, also in other diseases"
G6_POSTOPNEURO	Postprocedural disorders of nervous system
G6_POSTZOST	Postzoster neuralgia
G6_RADLES	Lesion of radial nerve
G6_ROOTPLEXOTHUNS	"Other and unspecified nerve root and plexus disorders, also in other diseases"
G6_SCIALE	Lesion of sciatic nerve
G6_SLEEPAPNO	Sleep apnoea
G6_SLEEPAPNO_INCLAVO	"Sleep apnoea, including avohilmo"
G6_SLEEPDISOTH	Other sleepdisorders
G6_SPINAMUSCOTH	Other and unspecified spinal muscular atrophies
G6_SPINOTH	Other diseases of spinal cord
G6_STATUSEPI	Status epilepticus
G6_TARSTUN	Tarsal tunnel syndrome
G6_TETRAPLE	Tetraplegia
G6_TIA	Transient ischemic attack
G6_TRINEU	Trigeminal neuralgia
G6_TRIOTHUNS	Other and unspecified trigeminal disorders
G6_ULLNLE	Lesion of ulnar nerve
G6_VASCSYND	Vascular syndromes of brain in cerebrovascular disorders
G6_XTRAPYR	Extrapyramidal and movement disorders
G6_XTRAPYROTH	Other extrapyramidal and movement disorders+ in other diseases
GASTRO_OPERATIONS	GASTRO-related operations
GAST_OPER	Any gastric operation
GE	Generalized epilepsy
GENERALI_SKIN_ERUPT_DRUGS_MEDICAM	Generalized skin eruption due to drugs and medicaments
GEST_DIABETES	Gestational diabetes (for exclusion)
GE_MODE	"Generalized epilepsy, mode (most common among epilepsy diagnosis)"
GE_STRICT	"Generalized epilepsy, strict definition"
GIANT_CELL_TEMP_ARTERITIS	Giant cell arteritis with polymyalgia rheumatica
GLOMER_NEPHRITIS	Glomerulonephritis
GOUT	"Gout, FINNGEN"
GOUT_COMORB	Gout-related co-morbidities
GOUT_IDIO	Idiopathic gout
GOUT_IDIOP_NOS	"Gout, strict definition"
GOUT_KIDNEY	Gout due to impairment of renal function
GOUT_NOS	"Gout, unspecified"
GOUT_STRICT	"Gout, strict definition"
H7_ALLERGICCONJUNCTIVITIS	Allergic conjunctivitis
H7_AMBLYANOPSIA	Amblyopia ex anopsia
H7_AMD	Age-related macular degeneration (whether dry or wet)
H7_ANISOMETROPIA	Anisometropia and aniseikonia
H7_ANOMAPUPFUNC	Anomalies of pupillary function
H7_APHAKIA	Aphakia
H7_ASTIGMATISM	Astigmatism
H7_BCKRNDRETINOPAT	Background retinopathy and retinal vascular changes
H7_BINOCUMOVOTH	Other disorders of binocular movement
H7_BINODISTOTH	Other disorders of binocular vision
H7_BLEPHAROCHALASIS	Blepharochalasis
H7_BLINDANDVISIMPAIRMENT	Visual impairment including blindness (binocular or monocular)
H7_BLINDMONOCULAR	"Blindness, monocular"
H7_BULLKERATOPATHY	Bullous keratopathy
H7_CATARACTOTHER	Other cataract
H7_CATARACTSENILE	Senile cataract
H7_CENTRRETARTOCC	Central retinal artery occlusion
H7_CHALAZION	Chalazion
H7_CHORIORETINFLAM	Chorioretinal inflammation
H7_CHOROIDOTH	Other disorders of choroid
H7_CHOROIDRETINA	Disorders of choroid and retina
H7_CONJUHAEMOR	conjunctival haemorrhage
H7_CONJUNAS	Other specified and unspecified disorders of conjunctiva
H7_CONJUNCTDEGDEPOT	conjunctival degenerations and deposits
H7_CONJUNCTIVA	Disorders of conjunctiva
H7_CONJUNCTIVITIS	Conjunctivitis
H7_CONJUNCTIVITISACUNONATOPIC	"Conjunctivitis (acute, non atopic)"
H7_CONJUNCTIVITISATOPIC	Atopic conjunctivitis
H7_CONJUNCTIVITISCHRON	Chronic conjunctivitis
H7_CONJUVASC	Other conjunctival vascular disorders and cysts
H7_CONVERGINSUFF	Convergence insufficiency and excess
H7_CONVERSTRAB	Convergent concomitant strabismus
H7_CORNEALDEFORM	Keratoconus
H7_CORNEALDYSTROPHY	Corneal degeneration
H7_CORNEALNAS	Other and unspecified corneal deformities and disorders
H7_CORNEALOTH	Other disorders of cornea
H7_CORNEALSCAR	Corneal scars and opacities
H7_CORNULCER	Corneal ulcer
H7_DACRYOADENITIS	Dacryoadenitis
H7_DIPLOPIA	Diplopia
H7_DISORDERLENSNAS	Other specified and unspecified disorders of lens
H7_DIVERGSTRAB	Divergent concomitant strabismus
H7_ECTROPION	Ectropion of eyelid
H7_ENTROPION	Entropion and trichiasis of eyelid
H7_EPIPHORA	Epiphora
H7_EPISCLERITIS	Episcleritis
H7_EXOPTHALMUS	Exophthalmic conditions
H7_EYE	Diseases of the eye and adnexa
H7_EYEADNEXOTH	Other specified and unspecified disorders of eye and adnexa
H7_EYELIDDIS	Other disorders of eyelid
H7_EYELIDINFLAMMATION	Other inflammation of eyelid
H7_EYELIDINOTH	Disorders of eyelid in diseases classified elsewhere
H7_EYELIDNAS	Other specified and unspecified  disorders of eyelid
H7_EYEOTH	Other disorders of eye and adnexa
H7_GLAUCCLOSEPRIM	Primary angle-closure glaucoma
H7_GLAUCNAS	Other and unspecified glaucoma
H7_GLAUCOMA	Glaucoma
H7_GLAUCOMAMEDICATION	Use of antiglaucoma preparations and miotics
H7_GLAUCOMA_NTG	Normotensive glaucoma
H7_GLAUCOMA_OPER	Glucoma-related operations
H7_GLAUCOMA_POAG	"Primary open-angle glaucoma, strict"
H7_GLAUCOMA_XFG	"Glaucoma, exfoliation"
H7_GLAUCPRIMOPEN	Primary open-angle glaucoma
H7_GLAUCSECDISEASE	Glaucoma secondary to other eye disorders
H7_GLAUCSECINFLAM	Glaucoma secondary to eye inflammation
H7_GLAUCSECTRAUMA	Glaucoma secondary to eye trauma
H7_GLAUCSUSP	Glaucoma suspect
H7_GLOBE	Disorders of globe
H7_GLOBEDEGENERATED	Degenerated conditions of globe
H7_HEREDRETINADYST	Hereditary retinal dystrophy
H7_HERPESKERATITIS	Herpesviral keratitis and keratoconjunctivitis
H7_HETEROPHORIA	Heterophoria
H7_HORDEOLUM	Hordeolum and other deep inflammation of eyelid
H7_HYPERMETRO	Hypermetropia
H7_INTERHETEROTRO	Intermittent heterotropia
H7_IRIDOACUTE	Acute and subacute iridocyclitis
H7_IRIDOCHRONIC	Chronic iridocyclitis
H7_IRIDOCYCLITIS	Iridocyclitis
H7_IRIDOCYCLITISINOTH	Iridocyclitis in diseases classified elsewhere
H7_IRIDONAS	Other and unspecified iridocyclitis
H7_KERATITIS	Keratitis
H7_KERATITISINOTH	Keratitis and keratoconjunctivitis in other diseases classified elsewhere
H7_KERATITISOTH	Other keratitis
H7_KERATOCONUS	Hereditary corneal dystrophies
H7_LACRIGLAND	Other disorders of lacrimal gland
H7_LACRIMALORBITINOTH	Disorders of lacrimal system and orbit in diseases classified elsewhere
H7_LACRIMALSYSTEM	Disorders of lacrimal system
H7_LACRIMINFLAMACU	Inflammation of lacrimal passages (acute and unspecified)
H7_LACRIMINFLAMCHRON	Inflammation of lacrimal passages (chronic)
H7_LAGOPHTALMOS	Lagophthalmos
H7_LENS	Disorders of lens
H7_LENSDISLOCATIO	Dislocation of lens
H7_LIDLACRIMALORBIT	"Disorders of eyelid, lacrimal system and orbit"
H7_MACULADEGEN	Degeneration of macula and posterior pole
H7_MACULOPATHYDIAB	Diabetic maculopathy
H7_MODVISIMPBINOC	"Moderate visual impairment, binocular"
H7_MYOPIA	Myopia
H7_NYSTAGMUS	Nystagmus and other irregular eye movements
H7_OCUMUSCLE	"Disorders of ocular muscles, binocular movement, accommodation and refraction"
H7_OCUPAIN	Ocular pain
H7_OPTATROPHY	Optic atrophy
H7_OPTICDISCOTH	Other disorders of optic disc
H7_OPTNERVE	Disorders of optic nerve and visual pathways
H7_OPTNERVNAS	"Disorders of optic nerve, not elsewhere classified"
H7_OPTNEURITIS	Optic neuritis
H7_OPTNEUROTH	Other disorders of optic [2nd] nerve and visual pathways
H7_ORBIT	Disorders of orbit
H7_ORBITINFLAMACU	Acute inflammation of orbit
H7_OTHERCONJ	Other disorders of conjunctiva
H7_OTHIRISCILIARY	Other disorders of iris and ciliary body
H7_OTHRETARTOCC	Other retinal artery occlusion
H7_PAPILLOEDEMA	"Papilloedema, unspecified"
H7_PARASTRA3	Third [oculomotor] nerve palsy
H7_PARASTRA4	Fourth [trochlear] nerve palsy
H7_PARASTRA6	Sixth [abducent] nerve palsy
H7_PARASTRAB	Paralytic strabismus
H7_PARASTRANAS	Other or unspecified paralytic strabismus
H7_PERIPHRETINADEGEN	Peripheral retinal degeneration
H7_PRESBYOPIA	Presbyopia
H7_PTERYGIUM	Pterygium
H7_PTOSIS	Ptosis of eyelid
H7_REFRAACCOMMODIS	Disorders of refraction and accommodation
H7_RETINAHAEMORR	Retinal haemorrhage
H7_RETINALBREAK	Retinal breaks without detachment
H7_RETINALDETACH	Retinal detachments and breaks
H7_RETINALDETACHBREAK	Retinal detachment with retinal break
H7_RETINALDETACHOTH	"Other, unspecified and serous retinal detachments"
H7_RETINALDETACHTRACTION	Traction detachment of retina
H7_RETINALDISOTH	Other retinal disorders
H7_RETINANAS	Other specified and unspecified retinal disorders
H7_RETINASEPAR	Separation of retinal layers (serosa)
H7_RETINAVASC	Retinal vascular disorders
H7_RETINOCHISISCYST	Retinoschisis and retinal cysts
H7_RETINOPATHYDIAB	Diabetic retinopathy
H7_RETINOPATHYDIAB_BKG	Diabetic background retinopathy
H7_RETINOPATHYDIAB_BKG_SEVERE	Severe diabetic background retinopathy
H7_RETINOPATHYDIAB_NAS	Other diabetic retinopathy
H7_RETINOPATHYDIAB_PROLIF	Proliferative diabetic retinopathy
H7_RETIVASCOCCLUSION	Retinal vascular occlusion
H7_RETVASCNAS	Other and unspecified vascular occlusions
H7_SCLERACORNEA	"Disorders of sclera, cornea, iris and ciliary body"
H7_SCLERITIS	Scleritis
H7_SCLERITISEPISCLERITIS	Scleritis and episcleritis
H7_SEVVISIMPMONOC	"Severe visual impairment, monocular"
H7_STENOLACRI	Stenosis and insufficiency of lacrimal passages
H7_STRABISMUS	Strabismus
H7_STRABNAS	Other specified and unspecified strabismus
H7_STRABOTH	Other strabismus
H7_USEOFEYEANTIALLERGENS	Use of eye-antiallergens (taken as indicator of allergic/atopic conjunctivitis)
H7_VASCCILIARY	Hyphaema and other vascular disorders of iris and ciliary body
H7_VERTISTRAB	Vertical strabismus
H7_VISDISTNAS	Other and unspecified visual disturbances
H7_VISFIELDDEF	Visual field defects
H7_VISUALDISTBLIND	Visual disturbances and blindness
H7_VISUDISTURB	Visual disturbances
H7_VISUDISTURBSUB	Subjective visual disturbances
H7_VITRBODYGLOBE	Disorders of vitreous body
H7_VITRCRYSTAL	Crystalline deposits in vitreous body
H7_VITREOUS	Disorders of vitreous body and globe
H7_VITRHAEMORR	Vitreous haemorrhage
H7_VITROPACIT	Other vitreous opacities
H7_VITROTH	Other and unspecified disorders of vitreous body
H7_XANTHELASMA	Xanthelasma of eyelid
H8_ABNAUDPER	Other abnormal auditory perceptions
H8_BPV	Benign paroxysmal vertigo
H8_CERUMEN	Impacted cerumen
H8_CHOLEASTOMA	Cholesteatoma of middle ear
H8_CHRON_SUPOTITIS	Chronic suppurative otitis media
H8_CONSENHEARINGLOSS	Conductive and sensorineural hearing loss
H8_EAR	Diseases of the ear and mastoid process
H8_EUSTNAS	Other disorders of Eustachian tube
H8_EUSTSALP	Eustachian salpingitis and obstruction
H8_EXTDISINOTH	"Disorder of external ear, unspecified"
H8_EXTDISNAS	Other specified disorders of external ear
H8_EXTERNAL	Diseases of external ear
H8_EXTOTITIS	Otitis externa
H8_EXT_ABSC	Abscess of external ear
H8_EXT_CELLUL	Cellulitis of external ear
H8_EXT_INFNAS	Other infective otitis externa
H8_EXT_NAS	"Otitis externa, unspecified"
H8_EXT_NONINF	"Acute otitis externa, noninfective"
H8_EXT_OTH	Other otitis externa (chronic)
H8_HL_CON_NAS	"Conductive hearing loss, unspecified"
H8_HL_DEAFMUT	"Deaf mutism, not elsewhere classified"
H8_HL_IDIOP	Sudden idiopathic hearing loss
H8_HL_MIX_NAS	Mixed conductive and sensorineural hearing loss
H8_HL_NAS	Other specified/unspecified hearing loss
H8_HL_PRESBY	Presbycusis
H8_HL_SEN_NAS	Sensorineural hearing loss
H8_INNER	Diseases of inner ear
H8_MASTACU	Acute mastoiditis
H8_MASTCHRON	Chronic mastoiditis
H8_MED_SUPP	Suppurative and unspecified otitis media
H8_MENIERE	Mnire disease
H8_MIDDLEADDH	Adhesive middle ear disease
H8_MIDDLEMASTOID	Diseases of middle ear and mastoid
H8_NOISEINNER	Noise effects on inner ear
H8_NONSUPPNAS	Nonsuppurative otitis media
H8_OTALGIA	Otalgia
H8_OTHEREAR	Other disorders of ear
H8_OTHHEARINGLOSS	Other hearing loss
H8_OTIMEDNAS	"Otitis media, unspecified"
H8_OTOSCLE	Otosclerosis
H8_PERCHRONDR	Perichondritis of external ear
H8_PERFORATION	Perforation of tympanic membrane
H8_PERIPHVERTIGO	Other peripheral vertigo
H8_POSTOP	"Postprocedural disorders of ear and mastoid process, not elsewhere classified"
H8_STENOEXTCAN	Acquired stenosis of external ear canal
H8_SUP_ACUTE	Acute suppurative otitis media
H8_SUP_OTINAS	"Suppurative otitis media, unspecified"
H8_TINNITUS	Tinnitus
H8_VERTIGO	Disorders of vestibular function (Vertigo)
H8_VERTIGOCENT	Vertigo of central origin
H8_VESTIBNEUR	Vestibular neuronitis
H8_VESTIFUNCNAS	Other/unspecified disorders of vestibular function
HERING_BILATERAL	"Inguinal hernia, bilateral"
HERING_UNILATERAL	"Inguinal hernia, unilateralk"
HYPOTE_DRUGS	Hypotension due to drugs
HYPOTHYROIDISM	Hypothyroidism (congenital or acquired)
HYPOTHY_LEVOTHY	"Hypothyroidism, levothyroxin purchases"
HYPOTHY_PURCHASE	Hypothyroidism and >3 levothyroxin purchases
HYPOTHY_REIMB	"Hypothyroidism, drug reimbursement"
I9_AF	Atrial fibrillation and flutter
I9_AF_EXNONE	Atrial fibrillation and flutter (no controls excluded)
I9_AF_REIMB	Atrial fibrillation and flutter with reimbursement
I9_ANEUR	Endovascular or surgical operations to intracerebral aneurysms
I9_ANEURYSM	"Cerebral aneurysm, nonruptured"
I9_ANEURYSM_EXNONE	"Cerebral aneurysm, nonruptured" (no controls excluded)
I9_ANEUR_EXNONE	Endovascular or surgical operations to intracerebral aneurysms (no controls excluded)
I9_ANGINA	Angina pectoris
I9_ANGINA_EXNONE	Angina pectoris (no controls excluded)
I9_ANGIO	Coronary angiopasty
I9_ANGIO_EXNONE	Coronary angiopasty (no controls excluded)
I9_AORTANEUR	Aortic aneurysm
I9_AORTANEUR_EXNONE	Aortic aneurysm (no controls excluded)
I9_AORTDIS	Dissection of aorta
I9_AORTDIS_EXNONE	Dissection of aorta (no controls excluded)
I9_ARTEMBTHR	Arterial embolism and thrombosis
I9_ARTEMBTHRLOW	Arterial embolism and thrombosis of lower extremity artery
I9_ARTEMBTHRLOW_EXNONE	Arterial embolism and thrombosis of lower extremity artery (no controls excluded)
I9_ARTEMBTHRNAS	Other arterial embolism and thrombosis
I9_ARTEMBTHRNAS_EXNONE	Other arterial embolism and thrombosis (no controls excluded)
I9_ARTEMBTHR_EXNONE	Arterial embolism and thrombosis (no controls excluded)
I9_ARTOTH	Other diseases of arteries and capillaries
I9_ARTOTH_EXNONE	Other diseases of arteries and capillaries (no controls excluded)
I9_ATHSCLE	"Atherosclerosis, excluding cerebral, coronary and PAD"
I9_ATHSCLE_EXNONE	"Atherosclerosis, excluding cerebral, coronary and PAD" (no controls excluded)
I9_AVBLOCK	AV-block
I9_AVBLOCK_EXNONE	AV-block (no controls excluded)
I9_CABG	Coronary artery bypass grafting
I9_CABG_EXNONE	Coronary artery bypass grafting (no controls excluded)
I9_CARDARR	Cardiac arrest
I9_CARDARR_EXNONE	Cardiac arrest (no controls excluded)
I9_CARDMPRI	"Cardiomyopathies, Primary/intrinsic"
I9_CARDMPRI_EXNONE	"Cardiomyopathies, Primary/intrinsic" (no controls excluded)
I9_CARDMSEC	"Cardiomyopathies, Secondary/extrinsic"
I9_CARDMSEC_EXNONE	"Cardiomyopathies, Secondary/extrinsic" (no controls excluded)
I9_CARDMYO	Cardiomyopathy
I9_CARDMYOHYP	"Cardiomyopathy, Hypertrophic obstructive"
I9_CARDMYOHYP_EXNONE	"Cardiomyopathy, Hypertrophic obstructive" (no controls excluded)
I9_CARDMYOOTH	"Cardiomyopathy, other and unspecified"
I9_CARDMYOOTH_EXNONE	"Cardiomyopathy, other and unspecified" (no controls excluded)
I9_CARDMYO_EXNONE	Cardiomyopathy (no controls excluded)
I9_CERATHER	Cerebral atherosclerosis
I9_CERATHER_EXNONE	Cerebral atherosclerosis (no controls excluded)
I9_CEREBATHER	Cerebral atherosclerosis
I9_CEREBDOTH	"Other specified cerebrovascular diseases, other cerebrovascular disorders in diseases classified elsewhere"
I9_CEREBDOTH_EXNONE	"Other specified cerebrovascular diseases, other cerebrovascular disorders in diseases classified elsewhere" (no controls excluded)
I9_CEREBVASC	Cerebrovascular diseases
I9_CHD	Major coronary heart disease event
I9_CONDUCTIO	Conduction disorders
I9_CONDUCTIO_EXNONE	Conduction disorders (no controls excluded)
I9_CORATHER	Coronary atherosclerosis
I9_CORATHER_EXNONE	Coronary atherosclerosis (no controls excluded)
I9_CVD	Cardiovascular diseases
I9_CVD_HARD	Hard cardiovascular diseases
I9_DISCER	"Dissection of cerebral arteries, nonruptured"
I9_DISCER_EXNONE	"Dissection of cerebral arteries, nonruptured" (no controls excluded)
I9_DISVEINLYMPH	"Diseases of veins, lymphatic vessels and lymph nodes, not elsewhere classified"
I9_DOAAC	"Diseases of arteries, arterioles and capillaries"
I9_DVTANDPULM	DVT of lower extremities and pulmonary embolism
I9_ENDOCARD	Endocarditis
I9_ENDOCARD_EXNONE	Endocarditis (no controls excluded)
I9_E_DRONE	Dronedarone medication
I9_E_DRONE_EXNONE	Dronedarone medication (no controls excluded)
I9_HEARTFAIL	"Heart failure,strict"
I9_HEARTFAIL_ALLCAUSE	All-cause Heart Failure
I9_HEARTFAIL_AND_ANTIHYPERT	Heart failure and antihypertensive medication
I9_HEARTFAIL_AND_CHD	
I9_HEARTFAIL_AND_HYPERTCARDIOM	Heart failure and hypertrophic cardiomyopathy
I9_HEARTFAIL_AND_OVERWEIGHT	Heart failure and bmi 25plus
I9_HEARTFAIL_EXNONE	"Heart failure,strict" (no controls excluded)
I9_HEARTFAIL_NS	"Heart failure, not strict"
I9_HYPERTENSION	Hypertensive diseases
I9_HYPERTROCARDMYOP	Hypertrophic cardiomyopathy
I9_HYPOTE	Hypotension
I9_HYPOTE_EXNONE	Hypotension (no controls excluded)
I9_HYPTENS	Hypertension
I9_HYPTENSEC	Secondary hypertension
I9_HYPTENSEC_EXNONE	Secondary hypertension (no controls excluded)
I9_HYPTENSESS	"Hypertension, essential"
I9_HYPTENSESS_EXNONE	"Hypertension, essential" (no controls excluded)
I9_HYPTENSHD	Hypertensive Heart Disease
I9_HYPTENSHD_EXNONE	Hypertensive Heart Disease (no controls excluded)
I9_HYPTENSHR	Hypertensive heart and/or renal disease
I9_HYPTENSHR_EXNONE	Hypertensive heart and/or renal disease (no controls excluded)
I9_HYPTENSPREG	"Hypertension complicating pregnancy, childbirth, and the puerperium"
I9_HYPTENSPUL	"Hypertension, Pulmonary Arterial"
I9_HYPTENSPUL_EXNONE	"Hypertension, Pulmonary Arterial" (no controls excluded)
I9_HYPTENSRD	Hypertensive Renal Disease
I9_HYPTENSRD_EXNONE	Hypertensive Renal Disease (no controls excluded)
I9_HYPTENS_EXNONE	Hypertension (no controls excluded)
I9_ICH	Intracerebral haemmorrhage
I9_ICH_EXNONE	Intracerebral haemmorrhage (no controls excluded)
I9_IHD	"Ischaemic heart disease, wide definition"
I9_INTRACRA	Nontraumatic intracranial haemmorrhage
I9_INTRACRA_EXNONE	Nontraumatic intracranial haemmorrhage (no controls excluded)
I9_ISCHHEART	Ischemic heart diseases
I9_K_CARDIAC	Death due to cardiac causes
I9_LBBB	Left bundle-branch block
I9_LBBB_EXNONE	Left bundle-branch block (no controls excluded)
I9_LYMPHADE	Nonspesific lymphadenitis
I9_LYMPHADE_EXNONE	Nonspesific lymphadenitis (no controls excluded)
I9_LYMPHOTH	Other noninfective disordersof lymphatic vessels and lymph nodes
I9_LYMPHOTH_EXNONE	Other noninfective disordersof lymphatic vessels and lymph nodes (no controls excluded)
I9_MI	Myocardial infarction
I9_MI_COMPLICATIONS	Complications following myocardial infarction
I9_MI_COMPLICATIONS_EXNONE	Complications following myocardial infarction (no controls excluded)
I9_MI_EXNONE	Myocardial infarction (no controls excluded)
I9_MI_STRICT	"Myocardial infarction, strict"
I9_MI_STRICT_EXNONE	"Myocardial infarction, strict" (no controls excluded)
I9_MYOCARD	Myocarditis
I9_MYOCARD_EXNONE	Myocarditis (no controls excluded)
I9_NONISCHCARDMYOP	Non-ischemic cardiomyopathy
I9_NONISCHCARDMYOP_STRICT	Nonischemic cardiomyopathy
I9_NONRHEVALV	Non-rheumatic valve diseases
I9_NONRHEVALV_EXNONE	Non-rheumatic valve diseases (no controls excluded)
I9_OTH	Other CVD
I9_OTHANEUR	Other aneurysm
I9_OTHANEUR_EXNONE	Other aneurysm (no controls excluded)
I9_OTHARR	Other arrhytmias
I9_OTHARR_EXNONE	Other arrhytmias (no controls excluded)
I9_OTHHEART	Other heart diseases
I9_OTHILLHEART	Other or ill-defined heart diseases
I9_OTHILLHEART_EXNONE	Other or ill-defined heart diseases (no controls excluded)
I9_OTHINTRACRA	Other intracranial haemorrhages
I9_OTHINTRACRA_EXNONE	Other intracranial haemorrhages (no controls excluded)
I9_OTHOTH	Other other unspecified disorders of the circulatory system
I9_OTHOTH_EXNONE	Other other unspecified disorders of the circulatory system (no controls excluded)
I9_OTHPER	Other peripheral vascular diseases
I9_OTHPER_EXNONE	Other peripheral vascular diseases (no controls excluded)
I9_PAD	Peripheral artery disease
I9_PAD_EXNONE	Peripheral artery disease (no controls excluded)
I9_PAROXTAC	Paroxysmal tachycardia
I9_PAROXTAC_EXNONE	Paroxysmal tachycardia (no controls excluded)
I9_PERICAOTH	Other diseases of pericardium
I9_PERICAOTH_EXNONE	Other diseases of pericardium (no controls excluded)
I9_PERICARD	Pericarditis
I9_PERICARD_EXNONE	Pericarditis (no controls excluded)
I9_PERIPH	Peripheral artery operations in Hilmo
I9_PERIPH_EXNONE	Peripheral artery operations in Hilmo (no controls excluded)
I9_PHLETHROM	Phlebitis and thrombophlebitis (not including DVT)
I9_PHLETHROMBDVTLOW	DVT of lower extremities
I9_PHLETHROMBDVTLOW_EXNONE	DVT of lower extremities (no controls excluded)
I9_PHLETHROM_EXNONE	Phlebitis and thrombophlebitis (not including DVT) (no controls excluded)
I9_POSTAMI	Status post-ami
I9_POSTAMI_EXNONE	Status post-ami (no controls excluded)
I9_PROGVASC	Progressive vascular leukoencephalopathy
I9_PROGVASC_EXNONE	Progressive vascular leukoencephalopathy (no controls excluded)
I9_PULMEMB	Pulmonary embolism
I9_PULMEMB_EXNONE	Pulmonary embolism (no controls excluded)
I9_PULMHEART	"Pulmonary heart disease, diseases of pulmonary circulation"
I9_PULMOTHHD	Other pulmonary heart/vessel disease
I9_PULMOTHHD_EXNONE	Other pulmonary heart/vessel disease (no controls excluded)
I9_PVT	Portal vein thrombosis
I9_PVT_EXNONE	Portal vein thrombosis (no controls excluded)
I9_RBBB	Right bundle-branch block
I9_RBBB_EXNONE	Right bundle-branch block (no controls excluded)
I9_REVACS	Emergency coronary revascularization (for ACS)
I9_REVACS_EXNONE	Emergency coronary revascularization (for ACS) (no controls excluded)
I9_REVASC	Coronary revascularization (ANGIO or CABG)
I9_REVASC_EXNONE	Coronary revascularization (ANGIO or CABG) (no controls excluded)
I9_RHEUFEV	Rheumatic fever incl heart disease
I9_RHEUFEVHRT	Rheumatic fever with heart involvement
I9_RHEUFEVHRT_EXNONE	Rheumatic fever with heart involvement (no controls excluded)
I9_RHEUVALV	Rheumatic valve diseases
I9_RHEUVALV_EXNONE	Rheumatic valve diseases (no controls excluded)
I9_SAH	Subarachnoid haemmorrhage
I9_SAHANEUR	"Aneurysms, operations, SAH"
I9_SAHANEUR_EXNONE	"Aneurysms, operations, SAH" (no controls excluded)
I9_SAH_EXNONE	Subarachnoid haemmorrhage (no controls excluded)
I9_SECONDRIGHT	Secondary right heart disease
I9_SECONDRIGHT_EXNONE	Secondary right heart disease (no controls excluded)
I9_SEQULAE	Sequelae of cerebrovascular disease
I9_SEQULAE_EXNONE	Sequelae of cerebrovascular disease (no controls excluded)
I9_STENOSIS	"Occlusion and stenosis of arteries, not leading to stroke"
I9_STENOSIS_EXNONE	"Occlusion and stenosis of arteries, not leading to stroke" (no controls excluded)
I9_STR	"Stroke, excluding SAH"
I9_STR_EXH	"Ischaemic Stroke, excluding all haemorrhages"
I9_STR_EXH_EXNONE	"Ischaemic Stroke, excluding all haemorrhages" (no controls excluded)
I9_STR_EXNONE	"Stroke, excluding SAH" (no controls excluded)
I9_STR_SAH	"Stroke, including SAH"
I9_STR_SAH_EXNONE	"Stroke, including SAH" (no controls excluded)
I9_THROMBICV	Nonpyogenic thrombosis of intracranial venous system
I9_THROMBICV_EXNONE	Nonpyogenic thrombosis of intracranial venous system (no controls excluded)
I9_THROMBOTH	Other embolism and thrombosis
I9_THROMBOTH_EXNONE	Other embolism and thrombosis (no controls excluded)
I9_TIA	Transient ischemic attack
I9_UAP	Unstable angina pectoris
I9_UAP_EXNONE	Unstable angina pectoris (no controls excluded)
I9_VALVES	Valvular operations
I9_VALVES_EXNONE	Valvular operations (no controls excluded)
I9_VARICVE	Varicose veins
I9_VARICVEOES	Oesophageal varices
I9_VARICVEOES_EXNONE	Oesophageal varices (no controls excluded)
I9_VARICVESOTH	Varicose veins of other sites
I9_VARICVESOTH_EXNONE	Varicose veins of other sites (no controls excluded)
I9_VARICVE_EXNONE	Varicose veins (no controls excluded)
I9_VASCDEM	Vascular dementia
I9_VASCINT	Vascular diseases of the intestine
I9_VASCSYND	Vascular syndromes of brain in cerebrovascular disorders
I9_VEINSOTH	Other disorders of veins
I9_VEINSOTH_EXNONE	Other disorders of veins (no controls excluded)
I9_VHD	Valvular heart disease including rheumatic fever
I9_VHD_EXNONE	Valvular heart disease including rheumatic fever (no controls excluded)
I9_VTE	Venous thromboembolism
IBD_BACT_INTEST_INFECTIONS	"Bacterial intestinal infections, IBD co-morbidities"
IBD_COMORB	"IBD co-morbidities, not ICD-10 XI"
IBD_DRUGS	Inflammatory bowel disease treatment related agents
IBD_INFECTIONS	"Infections, IBD-co-morbidities"
IBD_PULM	"Respiratory diseases principally affecting the interstitium, IBD co-morbidites"
ICDMAIN_ANY_ENTRY	Any ICDMAIN event in hilmo or causes of death
ILD	Interstitial lung disease
ILD_COMORB	ILD-related co-morbidities
ILD_CVDMETABOCOMORB	"ILD Co-morbidites, CVD and metabolic diseases"
ILD_DIFF_DG	ILD differential diagnosis
ILD_ENDPOINTS	Interstitial lung disease endpoints
ILD_FOR_EXCL	Diagnoses used for exclusion with ILD
ILD_HOSPITAL	"ILD, hospital admissions"
ILD_HOSPITAL_MAIN	"ILD, hospital admissions 1, main diag only"
ILD_HOSPITAL_PNEUMONIA_SEPSIS	"ILD, hospital admissions 3, with pneumonia sepsis"
ILD_HOSPITAL_PULM_INFECT	"ILD, hospital admission 2, with pulmonary infections"
ILD_INSUFFICIENCY	ILD-related respiratory insufficiency
ILD_SYST_AUTO	ILD related to systemic autoimmune disease
ILD_SYST_AUTO_DISEASES	Autoimmune diseases related-to ILD
INCREASEDMUSCLETONE	Increased muscle tone
INFLUENZA	All influenza (not pneumonia)
INSULINS	Insulin medication
INSULIN_SHORTFAST	"Insulin, fast-acting or short human"
INV_VENT	Invasive ventilation
IPF	Idiopathic pulmonary fibrosis
J10_ABSCLUNGPNEUMO	Abscess of lung
J10_ACUTELOWERNAS	Unspecified acute lower respiratory infection
J10_ACUTEUPPERINFEC	Acute upper respiratory infections of multiple and unspecified sites
J10_ARDS	Adult respiratory distress syndrome
J10_ASBESTPNEUMOC	Pneumoconiosis due to asbestos and other mineral fibres
J10_ASTHMA	Asthma
J10_ASTHMACOPDKELA	Asthma/COPD (KELA code 203)
J10_ASTHMA_EXMORE	Asthma (more controls excluded)
J10_ASTHMA_INCLAVO	"Asthma, including avohilmo"
J10_ASTHMA_MAIN	Asthma (only as main-diagnosis)
J10_ASTHMA_MAIN_EXMORE	Asthma (only as main-diagnosis) (more controls excluded)
J10_BRONCH	"Bronchitis, not specified as acute or chronic"
J10_BRONCHIECTASIS	Bronchiectasis
J10_BRONCHIOLITIS	Acute bronchiolitis
J10_BRONCHITIS	Acute bronchitis
J10_BRONCHNAS	Unspecified chronic bronchitis
J10_CHEMGASRESP	"Respiratory conditions due to inhalation of chemicals, gases, fumes and vapours"
J10_CHRONLARYNGITIS	Chronic laryngitis and laryngotracheitis
J10_CHRONRHINITIS	"Chronic rhinitsi, nasopharyngitis and pharyngitis"
J10_CHRONSINUSITIS	Chronic sinusitis
J10_CHRONTONSADEN	Chronic diseases of tonsils and adenoids
J10_COLD	Acute nasopharyngitis(common cold)
J10_COPD	COPD
J10_COPDNAS	Other chronic obstructive pulmonary disease
J10_COPDNAS_INCLAVO	Other chronic obstructive pulmonary disease
J10_EMPHYSEMA	Emphysema
J10_EPIGLOTTITIS	Acute epiglottitis
J10_EXTERLUNG	Lung diseases due to external agents
J10_HYPERSPNEUMONI	Hypersensitivity pneumonitis due to organic dust
J10_INFLUENZA	All influenza
J10_INFLUPNEU	Influenza and pneumonia
J10_INTERSTITIUM	Other respiratory diseases principally affecting the interstitium
J10_LARYNGITIS	Acute laryngitis and tracheitis
J10_LOWCHRON	Chronic lower respiratory diseases
J10_LOWERINF	Other acute lower respiratory infections
J10_NASALPOLYP	Nasal polyp
J10_NECROTIC	Suppurative and necrotic conditions of lower respiratory tract
J10_OTHERINSTPULM	Other insterstitial pulmonary diseases
J10_PERITONSABSC	Peritonsillar abscess
J10_PHARYNGITIS	Acute pharyngitis
J10_PLEURA	Other diseases of pleura
J10_PLEUREFFUSION	Pleural effusion
J10_PLEUROTH	Other pleural conditions
J10_PLEURPLAGUE	Pleural plaque
J10_PNEUMOBACT	Bacterial pneumoniae
J10_PNEUMOBACTEROTH	"Bacterial pneumonia, not elsewhere classified"
J10_PNEUMONAS	"Pneumonia, organism unsepcified"
J10_PNEUMONIA	All pneumoniae
J10_PNEUMONISOLLIQ	Pneumonitis due to solids and liquids
J10_PNEUMONONBACT	"Pneumonia due to other infectious organisms, not elsewhere classified"
J10_PNEUMOPNEUMO	Pneumonia due to Streptococcus pneumoniae
J10_PNEUMOPROBBAC	Pneumonia (excl. viral and due to other infectious organisms not elsewhere classified)
J10_PNEUMOTHORAX	Pneumothorax
J10_PULMEOS	"Pulmonary eosinophilia, not elsewhere classified"
J10_PULMOEDEMA	Pulmonary oedema
J10_PYOTHORAX	Pyothorax
J10_RESPCONDEXT	Respiratory conditions due to other external agents
J10_RESPDISOTH	Other respiratory disorders and diseases
J10_RESPIRATORY	Diseases of the respiratory system
J10_RESPOTHER	Other diseases of the respiratory system
J10_SEPTDEV	Deviated nasal septum
J10_SIMPLBRONCH	Simple and mucoplurulent chronic bronchitis
J10_SINUSITIS	Acute sinusitis
J10_TONSILLITIS	Other and unspecified tonssillitis
J10_UPPERDIS	Other diseases of upper respiratory tract
J10_UPPERINFEC	Acute upper respiratory infections
J10_VASOALLERRHIN	Vasomotor and allergic rhinitis
J10_VIRALPNEUMO	Viral pneumonia
J10_VOCALLARYNX	"Diseases of vocal cords and larynx+other diseases of upper respiratory tract, no elsewhere classified"
JOINTPAIN	Pain in joint
JUVEN_ARTHR	Juvenile arthritis (FINNGEN)
JUVEN_ARTHR_COMORB	Juvenile arthritis related co-morbidities
K11_ABSCANAL	Abscess of anal and rectal regions
K11_ACHAL	Achalasia of cardia
K11_ACUTGASTR	Acute gastritis
K11_ACUTPANC	Acute pancreatitis
K11_ADHE	Intestinal adhesions without obstruction
K11_ALCGASTR	Alcoholic gastritis
K11_ALCOLIV	Alcoholic liver disease
K11_ANOMALI_DENTAL_ARCH_RELATIONS1	Anomalies of dental arch relationship
K11_ANOMALI_JAW_C_BASE_RELATIONS	Anomalies of jaw-cranial base relationship
K11_APPENDACUT	Acute appendicitis
K11_APPENDIX	Diseases of appendix
K11_APPENDOTH	Other appendicitis
K11_ASYMMETRY_JAW	Asymmetry of jaw
K11_ATROPHY_SALIVARY_GLAND	Atrophy of salivary gland
K11_ATTRITION	Excessive attrition of teeth
K11_BARRET	Barret oesophagus
K11_BILIAOTH	Other diseases of biliary tract
K11_CARIES	Dental caries
K11_CD_NOUC	"Crohn disease (strict definition, all UC cases excluded)"
K11_CD_STRICT	"Crohn disease (strict definition, require KELA)"
K11_CD_STRICT2	"Crohn disease (strict definition, require KELA, min 2 HDR)"
K11_CHOLANGI	"Cholangitis (primary sclerosing, PSC)"
K11_CHOLANGI_STRICT	"Cholangitis (primary sclerosing, PSC), with reimbursement 202"
K11_CHOLECYST	Chlocystitis
K11_CHOLELITH	Cholelithiasis
K11_CHRONGASTR	Chronic gastritis
K11_CHRONHEP	"Chronic hepatitis, not elsewhere classified"
K11_CHRONPANC	Chronic pancreatitis
K11_COELIAC	Coeliac disease
K11_CONSTIPATION	Constipation
K11_CROHN	Crohn disease
K11_CROSSBITE	Crossbite
K11_CROWDI_TEETH	Crowding of teeth
K11_DEEP_BITE	Deep bite
K11_DENTOFACIAL_ANOMALIES	Dentofacial anomalies [including malocclusion]
K11_DEPOSITS	Deposits [accretions] on teeth
K11_DIAHER	Diaphragmatic hernia
K11_DISLIVOTH	Other diseases of liver
K11_DISOESINOTH	Disorders of oesophagus in diseases classified elsewhere
K11_DISORD_TEETH	Other disorders of teeth and supporting structures
K11_DISTAL_BITE	Distal bite
K11_DIVERTIC	Diverticular disease of intestine
K11_DULC	Duodenal ulcer
K11_EMBED_TEETH	Embedded teeth
K11_EMBIMPACT_TEETH	Embedded and impacted teeth
K11_ENERCOLNONINF	Noninfective enteritis and colitis
K11_EROSION	Erosion of teeth
K11_ERUPTION	Tooth eruption problems
K11_FEMHER	Femoral hernia
K11_FIBROCHIRLIV	Fibrosis and chirrhosis of liver
K11_FISSANAL	Fissure and fistula of anal and rectal regions
K11_FISTULA	Colonic or urogenital fistula
K11_FUNCDYSP	Functional dyspepsia
K11_GALLBILPANC	"Disorders of gallbladder, biliary tract and pancreas"
K11_GALLBLAOTH	Other diseases of gallbladder
K11_GASTRODUOULC	Gastroduodenal ulcer
K11_GIBLEEDING	GI-bleeding
K11_GIDISEASES	Gastrointestinal diseases
K11_GINGIVA	Other disorders of gingiva and edentulous alveolar ridge
K11_GINGIVITIS_ACUTE	Acute gingivitis
K11_GINGIVITIS_CHRONIC	Chronic gingivitis
K11_GINGIVITIS_PERIODONTAL	Gingivitis and periodontal diseases
K11_GJULC	Gastrojejunal ulcer
K11_GULC	Gastric ulcer
K11_HAEMORR	Haemmorrhoids and perianal venous thrombosis
K11_HEPFAIL	"Hepatic failure, not elsewhere classified"
K11_HERING	Inguinal hernia
K11_HERNIA	Hernia
K11_HYPODONTIA	Hypodontia
K11_HYPO_ONLY	Tooth agenesis EXCLUDE clefts and syndromes
K11_IBD	Inflammatory bowel disease
K11_IBD_STRICT	"Inflammatory bowel disease, strict (require KELA)"
K11_IBD_STRICT_PSC	IBD (strict) with PSC
K11_IBS	Irritable bowel syndrome
K11_ILEUS	Paralytic ileus and intestinal obstruction
K11_IMPACT	Impaction of intestines
K11_IMPACTED_TEETH	Impacted teeth
K11_INTESTOTH	Other diseases of intestines
K11_INTUSS	Intussusception
K11_JAWS	Other diseases of jaws
K11_KELACROHN	"Crohn's disease patients in KELA-register (KELA code 209, or 208 with ICD K50)"
K11_KELAIBD	IBD patients in KELA-register
K11_KELAUC	"UC patients in KELA-register ( KELA 208 prior to 1994, or ICD K51)"
K11_KELAUC1	"UC patients in KELA-register (code 208), prior to 1994"
K11_LIP_ORAL_MUCOSA	Other diseases of lip and oral mucosa
K11_LIVER	Diseases of liver
K11_MAJOR_ANOMALI_JAW_SIZE	Major anomalies of jaw size
K11_MALABSORB	Intestinal malabsorbtion
K11_MANDIBULAR_MOLAR_FAILED_ERUPT_OBSTRUCTION_TOOTH	Mandibular molar that has failed to erupt because of obstruction by another tooth
K11_MAXIL_MOLAR_FAILED_ERUPT_OBSTRUCTION_TOOTH	Maxillary molar that has failed to erupt because of obstruction by another tooth
K11_MN_PROGN_AND_SURGRT	Mandibular prognathia AND surgery (LeFortI or BSSO or LeFortI AND BSSO)
K11_MN_RERTGN_AND_SURG	Mandibular retrognathia AND surgery (BSSO)
K11_OESITIS	Oesophagitis
K11_OESOBST	Oesophageal obstruction
K11_OESSTODUO	"Diseases of oesophagus, stomach and duodenum"
K11_OESULC	Ulcer of oesophagus
K11_OPEN_BITE	Open bite
K11_ORAL	"Diseases of oral cavity, salivary glands and jaws"
K11_ORALCYST	"Cysts of oral region, not elsewhere classified"
K11_OTHABDHER	Other and unspecified abdominal hernia
K11_OTHANRECT	Other diseases of anus and rectum
K11_OTHAPPEND	Other diseases of appendix
K11_OTHDIG	Other diseases of the digestive system
K11_OTHDISDIG	Other diseases of the digestive system
K11_OTHDISOES	Other diseases of oesophagus
K11_OTHDISSTOMDUOD	Other diseases of stomach and duodenum
K11_OTHENTERCOL	Other noninfective gastroenteritis and colitis
K11_OTHFUNC	Other functional intestinal disroders
K11_OTHGASTR	Other gastritis (incl. Duodenitis)
K11_OTHILEUS	"Other or unspecified ileus, impaction or obstruction"
K11_OTHINFLIV	Other inflammatory liver diseases
K11_OTHINT	Other diseases of intestine
K11_OTHPERITON	Other diseases of peritoneum
K11_OVERJET	Overjet
K11_PANCOTH	Other diseases of pancreas
K11_PARALIL	Paralytic ileus
K11_PERIODON_ACUTE	Acute periodontitis
K11_PERIODON_CHRON	Chronic periodontitis
K11_PERITON	Diseases of peritoneum
K11_PERITONITIS	Acute peritonitis
K11_POSTOPDIS	"Postprocedural disorders of digestive system, not elsewhere classified"
K11_PSC_COLITIS	"Colitis, primary sclerosing"
K11_PSC_COLITIS_STRICT	"Colitis, primary sclerosing, strict definition"
K11_PULC	Peptic ulcer
K11_PULP_PERIAPICAL	Diseases of pulp and periapical tissues
K11_REFLUX	Gastro-oesophageal reflux disease
K11_REIMB_202	KELA_REIMBURSEMENT_202
K11_RETROG_MAXILLAE	Maxillary retrognathism
K11_SALIVARY	Diseases of salivary glands
K11_STOMATITIS	Stomatitis and related lesions
K11_STRICTURE	Intestinal stricture
K11_TEETH_HARD	Other diseases of hard tissues of teeth
K11_TONGUE	Diseases of tongue
K11_TOOTH_DEV	Disorders of tooth development and eruption
K11_TOXLIV	Toxic liver disease
K11_UC_NOCD	"Ulcerative colitis (strict definition, all Crohn cases excluded)"
K11_UC_STRICT	"Ulcerative colitis (strict definition, require KELA)"
K11_UC_STRICT2	"Ulcerative colitis (strict definition, require KELA, min 2 HDR)"
K11_UC_STRICT_PSC	Ulcerative colitis (strict) with PSC
K11_ULCER	Ulcerative colitis
K11_UMBHER	Umbilical hernia
K11_VASCINT	Vascular disorders of the intestines
K11_VENTHER	Ventral hernia
K11_VOLVU	Volvulus
KELA_DIAB_INSUL	"Diabetes, insuline treatment (Kela reimbursement)"
KELA_DIAB_INSUL_EXMORE	"Diabetes, insuline treatment (Kela reimbursement)" (more controls excluded)
KNEE_ARTHROSIS	Gonarthrosis [arthrosis of knee](FG)
KRA_PSY_ALCOH	"Alcohol abuse, main dg"
KRA_PSY_ALCOH_EXMORE	"Alcohol abuse, main dg" (more controls excluded)
KRA_PSY_ANXIETY	Anxiety disorders
KRA_PSY_ANXIETY_EXMORE	Anxiety disorders (more controls excluded)
KRA_PSY_ANYMENTAL	Any mental disorder
KRA_PSY_ANYMENTAL_SUICID_PREG_NERV	"Any mental disorder, or suicide (or attempt), or psychic disorders complicating pregnancy, partum or puerperum or nerve system disorders"
KRA_PSY_AUTISM	Autism spe
KRA_PSY_AUTISM_EXMORE	Autism spe (more controls excluded)
KRA_PSY_BEHAV	Behavioural disorders
KRA_PSY_BEHAV_EXMORE	Behavioural disorders (more controls excluded)
KRA_PSY_CHILDEMOT	Emotional disorders starting during childhood or adolecense
KRA_PSY_CHILDEMOT_EXMORE	Emotional disorders starting during childhood or adolecense (more controls excluded)
KRA_PSY_CHILDSOC	Social disorders starting during childhood or adolecense
KRA_PSY_CHILDSOC_EXMORE	Social disorders starting during childhood or adolecense (more controls excluded)
KRA_PSY_CODUCTEMOT	Mixed disorders of conduct and emotions
KRA_PSY_CODUCTEMOT_EXMORE	Mixed disorders of conduct and emotions (more controls excluded)
KRA_PSY_DEMENTIA	Any dementia
KRA_PSY_DEMENTIA_EXMORE	Any dementia (more controls excluded)
KRA_PSY_DEVWIDE	Wide developmental disorders
KRA_PSY_DEVWIDE_EXMORE	Wide developmental disorders (more controls excluded)
KRA_PSY_EATING	KRA_PSY_EATING
KRA_PSY_EATING_EXMORE	KRA_PSY_EATING (more controls excluded)
KRA_PSY_HYPERKIN	Hyperkinetic disorders
KRA_PSY_HYPERKIN_EXMORE	Hyperkinetic disorders (more controls excluded)
KRA_PSY_MENTALRET	Mental retardation
KRA_PSY_MENTALRET_EXMORE	Mental retardation (more controls excluded)
KRA_PSY_MOOD	Mood disorders
KRA_PSY_MOOD_EXMORE	Mood disorders (more controls excluded)
KRA_PSY_MOTOR	Motor disorders
KRA_PSY_MOTOR_EXMORE	Motor disorders (more controls excluded)
KRA_PSY_PERSON	Personality disorders
KRA_PSY_PERSON_EXMORE	Personality disorders (more controls excluded)
KRA_PSY_PUERPER	"Mental and behabioural disorders of puerperum, not classified elsewhere"
KRA_PSY_PUERPER_EXMORE	"Mental and behabioural disorders of puerperum, not classified elsewhere" (more controls excluded)
KRA_PSY_SCHIZODEL	Schizophrenia or delusion
KRA_PSY_SCHIZODEL_EXMORE	Schizophrenia or delusion (more controls excluded)
KRA_PSY_SLEEP_NONORG	Nonorganic sleeping disorders
KRA_PSY_SLEEP_NONORG_EXMORE	Nonorganic sleeping disorders (more controls excluded)
KRA_PSY_SPEELING	Speech and linguistic disorders
KRA_PSY_SPEELING_EXMORE	Speech and linguistic disorders (more controls excluded)
KRA_PSY_SUBSTANCE	Substance abuse
KRA_PSY_SUBSTANCE_EXMORE	Substance abuse (more controls excluded)
KRA_PSY_TIC	Tic disorders
KRA_PSY_TIC_EXMORE	Tic disorders (more controls excluded)
L12_ABSCESS_CUT	"Cutaneous abscess, furuncle and carbuncle"
L12_ACNE	Acne
L12_ACNE_NAS	Other  and unspecified acne
L12_ACNE_VULGARIS	Acne vulgaris
L12_ACTINKERA	Actinic keratosis
L12_ALLERGICCONTACT	Alergic contact dermatitis
L12_ALOPECANDRO	Androgenic alopecia
L12_ALOPECAREATA	Alopecia areata
L12_ATOPIC	Atopic dermatitis
L12_ATROPHICSKIN	Atrophic disorders of skin
L12_BULLOTH	Other bullous disorders
L12_BULLOUS	Bullous disorders
L12_CELLULITIS	Cellulitis
L12_CHRONICULCEROFSKIN	"Chronic ulcer of skin, not elsewhere classified"
L12_CORNSANDCALLOS	Corns and callosities
L12_CUTLAXSEN	Cutis laxa senilis
L12_DECUBITANSULCERANDPRESSURE	Decubitus ulcer and pressure area
L12_DERMATHERP	Dermatitis herpetiformis
L12_DERMATITISECZEMA	Dermatitis and eczema
L12_DERMATITISNAS	Other and unspecified dermatitis
L12_DERM_NAS	Other and unspecified dermatitis
L12_DERM_NUMMULAR	Nummular dermatitis
L12_DISORDSKINAPPENDIX	Disorders of skin appendages
L12_DYSHIDROSIS	Dyshidrosis [pompholyx]
L12_EPIDERMALTHICKOTH	Other epidermal thickening
L12_EPIDERMTHICKNAS	Other and unspecified epidermal thickening
L12_ERYTHEMAMULTIF	Erythema multiforme
L12_ERYTHEMANODOSUM	Erythema nodosum
L12_ERYTHEMATOUSOTH	Other erythematous conditions
L12_ERYTHRO_KELA	"Universal eryhrodermia, KELA reimbursement"
L12_ERYTH_NAS	Other and unspecified erythematous conditions
L12_ERYT_INTERTRIG	Erythema intertrigo
L12_EXFOLIATIVE	Exfoliative dermatitis
L12_FACTITIALDERMAT	Factitial dermatitis
L12_FOLICULAROTH	Other follicular disorders
L12_FOLLICULARCYST	Follicular cysts of skin and subcutaneous tissue
L12_FOLLICULARNAS	Other and unspecified follicular disorders
L12_FOODDERMAT	Dermatitis due to ingested food
L12_GRANUANNU	Granuloma annulare
L12_GRANULOMATOUSSKIN	Granulomatous disorders of skin and subcutaneous tissue
L12_HAIRLOSSNONSCAR	Other nonscarring hair loss
L12_HAIRLOSSSCAR	Cicatricial alopecia [scarring hair loss]
L12_HIDRADENITISSUP	Hidradenitis suppurativa
L12_HIRSUTISM	Hirsutism
L12_HYPERTRICHOSIS	Hypertrichosis
L12_HYPERTROPHICSKIN	Hypertrophic disorders of skin
L12_HYPETROPHICSCAR	Hypertrophic scar
L12_IMPETIGO	Impetigo
L12_INFECT_DERM	Infective dermatitis
L12_INFECT_SKIN	Infections of the skin and subcutaneous tissue
L12_INFECT_SKIN_NAS	Other and unspecified local infections of skin and subcutaneous tissue
L12_INFECT_SKIN_OTHER	Other local infections of skin and subcutaneous tissue
L12_INTERNALSUBSTANCEDERM	Dermatitis due to substances taken internally
L12_LICHENPLANUS	Lichen planus
L12_LICHENSCLERATROPH	Lichen sclerosus et atrophicus
L12_LICHENSIMPLEX	Lichen simplex chronicus
L12_LICHSIMPANDPRURIGO	Lichen simplex chronicus and prurigo
L12_LOCALDCONNECTISSUEOTH	Other localized connective tissue disorders
L12_LOCALSCLERODERMA	Localized scleroderma [morphea]
L12_LUPUS	Lupus erythematosus
L12_LYMPHADENITIS	Acute lymphadenitis
L12_NAILDIS	Nail disorders
L12_NAILNAS	Other and unspecified nail disorders
L12_NAIL_DYSTROPHY	Nail dystrophy
L12_NAIL_INGROW	Ingrowing nail
L12_NECROLIPOIDIC	"Necrobiosis lipoidica, not elsewhere classified"
L12_NONIONRADISKIN	Skin changes due to chronic exposure to nonionizing radiation
L12_NONIONRADISKINNAS	Other and unspecified skin changes due to chronic exposure to nonionizing radiation
L12_OTHACUSKINSUN	Other acute skin changes due to ultraviolet radiation
L12_OTHACUSKINSUNNAS	Other and unspecified acute skin changes due to ultraviolet radiation
L12_OTHERBULL	Other and unspecified bullous disorders
L12_OTHERCONTACT	Other contact dermatitis
L12_OTHERDISSKINANDSUBCUTIS	"Other disorders of skin and subcutaneous tissue, not elsewhere classified"
L12_OTHERMELANIN	Other melanin hyperpigmentation
L12_OTHERSKINSUBCUTIS	Other disorders of skin and subcutaneous tissue
L12_OTHPIGMENTATION	Other disorders of pigmentation
L12_PAPULOSQUAMOUS	Papulosquamous disorders
L12_PAPULOSQUAOTH	Other papulosquamous disorders
L12_PARAPSORI	Parapsoriasis
L12_PEMPHIGOID	Pemphigoid
L12_PEMPHIGOID_BULL	Bullous pemphigoid
L12_PERIORALDERM	Perioral dermatitis
L12_PIGMENTNAS	Other and unspecified disorders of pigmentation
L12_PIGPURPDERM	Pigmented purpuric dermatosis
L12_PILONIDALCYST	Pilonidal cyst
L12_PITYROCHEA	Pityriasis rosea
L12_POLYMORPHLIGHTERUPT	Polymorphous light eruption
L12_PRURIGONAS	Other  prurigo
L12_PRURIGONOD	Prurigo nodularis
L12_PRURITUS	Pruritus
L12_PSORIASIS	Psoriasis
L12_PSORI_ARTHRO	Arthropathic psoriasis
L12_PSORI_GUTTATE	Guttate psoriasis
L12_PSORI_NAS	Other and unspecified psoriasis
L12_PSORI_PUSTUPALM	Pustulosis palmaris et plantaris
L12_PSORI_VULG	Psoriasis vulgaris
L12_PYODERMA	Pyoderma
L12_PYOGENGRANUL	Pyogenic granuloma
L12_RADIATIONRELATEDSKIN	Radiation-related disorders of the skin and subcutaneous tissue
L12_ROSACEA	Rosacea
L12_ROSACEANAS	Other and unspcified rosacea
L12_SCARCONDITIONS	Scar conditions and fibrosis of skin
L12_SEBORRHOEIC	Seborrhoeic dermatitis
L12_SEBORRKERAT	Seborrhoeic keratosis
L12_SKIN	Diseases of the skin and subcutaneous tissue
L12_SKINSUBCUTISNAS	Other and unspecified disorders of skin and subcutaneous tissue
L12_STRIAEATROPHICAE	Striae atrophicae
L12_ULCERLOWLIMB	"Ulcer of lower limb, not elsewhere classified"
L12_URTICARIA	Urticaria
L12_URTICARIAERYTHEMA	Urticaria and erythema
L12_URTICA_ALLERG	Allergic urticaria
L12_URTICA_COLDHEAT	Urticaria due to cold and heat
L12_URTICA_DERTMATOG	Dermatographic urticaria
L12_URTICA_IDIOPAT	Idiopathic urticaria
L12_URTICA_NAS	Other and unspecified urticaria
L12_VASCULITISNAS	Other and unspecified vasculitis limited to skin
L12_VASCULITISSKIN	"Vasculitis limited to skin, not elsewhere classified"
L12_VITILIGO	Vitiligo
L12_XEROSCUT	Xerosis cutis
LOCALIZED_SKIN_ERUPT_DRUGS_MEDICAM	Localized skin eruption due to drugs and medicaments
LUNG_CANCER_MESOT	Lung cancer and mesothelioma
LUNG_TRANSPLANTATION	Lung transplantation
M13_ACHILLESTEND	Achilles tendinitis
M13_ADHCAPSULITIS	Adhesive capsulitis of shoulder
M13_ALGONEURO	Alogoneurodystrophy
M13_ANKLEFOOT	Other acquired deformities of ankle and foot
M13_ANKYLOSISJOINT	Ankylosis of joint
M13_ANKYLOSPON	Ankylosing spondylitis
M13_ANKYLOSPON_STRICT	"Ankylosing spondylitis, strict definition"
M13_ARTHINOTH	Arthropathies in other diseases classified elsewhere
M13_ARTHRITISNAS	Ohter specific/unspecified arthritis
M13_ARTHROPATHIES	Arthropathies
M13_ARTHROSIS	Arthrosis
M13_ARTHROSIS_INCLAVO	"Artrosis, including avohilmo"
M13_ARTHROSIS_KNEE	Gonarthrosis
M13_ARTHROSIS_KNEE_PRIM_ICD10	"Gonarthrosis,primary"
M13_ARTHROSIS_KNEE_PRIM_KNEESURG	"Gonarthrosis, primary, with knee surgery"
M13_ARTHROSIS_OTH	Other arthrosis
M13_ARTHROSIS_POLY	Polyarhtrosis
M13_ARTHTROSIS_COX	"Coxarthrosis,"
M13_ARTHTROSIS_COX_PRIM_HIPSURG	"Coxarthrosis, primary, with hip surgery"
M13_ARTHTROSIS_COX_PRIM_ICD10	"Coxarthrosis, primary"
M13_ATLOAXSUBLUX	Atlantoaxial subluxation
M13_BAKERCYST	Synovial cyst of popliteal space [Baker]
M13_BICIPITALTEND	Bicipital tendinitis
M13_BIOMECHLESIO	"Biomechanical lesions, not elsewhere classified"
M13_BONECONTINUITY	Disorders of continuity of bone
M13_BONEDENSOTH	Other disorders of bone density and structure
M13_BONEDISNAS	Other specified/unspecified disorders of  bone/cartilage
M13_BURSCYSTOTH	Other bursal cyst
M13_BURSELBOWOTH	Other bursitis of elbow
M13_BURSITISHIPOTH	Other bursitis of hip
M13_BURSITISKNEEOTH	Other bursitis of knee
M13_BURSITISOTH	"Other bursitis, not elsewhere classified"
M13_BURSOPATHY	Other bursopathies
M13_CALCANSPUR	Calcaneal spur
M13_CALCIFICTEND	Calcific tendinitis of shoulder
M13_CALCTENDINITIS	Calcific tendinitis
M13_CARTILAGE	Other articular cartilage disorders
M13_CERVICALGIA	Cervicalgia
M13_CERVICDISC	Cervical disc disorders
M13_CERVICOBRACHSDR	Cervicobrachial syndrome
M13_CERVICOCRANSDR	Cervicocranial syndrome
M13_CHONDROMALACIA	Chondromalacia
M13_CHRONDROPATHIES	Chrondropathies
M13_CHRONSYNOVITISHANDWRIST	Chronic crepitant synovitis/bursitis of hand and wrist/periarhritis of wrist
M13_CONNECTNAS	Other specified/unspecified systemic involvement of connective tissue
M13_CONTRACTUREJOINT	Contracture of joint
M13_CRYSTALARTH	Other crystal arthropathies
M13_DEFORMACQ	Other acquired deformities of musculoskeletal system and connective tissue
M13_DEFORMDORSO	Deforming dorsopathies
M13_DEFORMDORSONAS	Other specified/unsepecified deforming dorsopathies
M13_DEQUERVAIN	Radial styloid tenosynovitis [de Quervain]
M13_DERMATOPOLY	Dermatopolymyositis
M13_DISCINFECTION	Infection of intervertebral disc (pyogenic)
M13_DISCITIS	"Discitis, unspecified"
M13_DISSYNOTENDNAS	Other specified/unspecified disorders of synovium and tendon +Other specified/unspecified bursopathies
M13_DORSALGIA	Dorsalgia
M13_DORSALGIANAS	Other/unspecified dorsalgia
M13_DORSOPATHY	Dorsopathies
M13_DORSOPATHYNAS	Other specified/unspecified dorsopathies
M13_DORSOPATHYOTH	"Other dorsopathies, not elsewhere classified"
M13_DUPUTRYEN	Palmar fascial fibromatosis [Dupuytren]
M13_ENTEROARTHR	Enteropathic arthropathies
M13_ENTESOPATHYFOOT	Oher enthesopathy of foot (+metatarsalgia)
M13_ENTESOPATHYLOW	"Enthesopathies of lower limb, excluding foot"
M13_ENTESOPATHYLOWNAS	"Other/unspecified enthesopathies of lower limb, excluding foot"
M13_ENTESOPATHYNAS	"Other/unspecified enthesopathies, not elsewhere classified"
M13_ENTESOPATHYOTH	Other enthesopathies
M13_FATPADHYPERTROPHY	Hypertrophy of (infrapatellar) fat pad
M13_FIBROBLASTIC	Fibroblastic disorders
M13_FIBROMYALGIA	Fibromyalgia
M13_FINGERDEFORM	Deformity of finger(s)
M13_FLATFOOT	Flat foot [pes planus] (acquired)
M13_FOREIGNBODY	Residual foreign body in soft tissue
M13_FORESTIER	Ankylosing hyperostosis [Forestier]
M13_GANGLION	Ganglion
M13_GIANTCELL	Giant cell arteritis
M13_GLUTEALTEND	Gluteal tendinitis
M13_GOUT	Gout
M13_HALLUDEFORMOTH	Other deformity of hallux (acquired)
M13_HALLUXRIGIDUS	Hallux rigidus
M13_HALLUXVALGUS	Hallux valgus (acquired)
M13_HAMMERTOE	Other hammer toe(s) (acquired)
M13_HTROMBMICROANG	Thrombotic microangiopathy
M13_HYPERANG	Hypersensitivity angiitis
M13_HYPERMOBILITY	Hypermobility syndrome
M13_ILIOTIBBAND	Iliotibial band syndrome
M13_IMPINGEMENT	Impingement syndrome of shoulder
M13_INFBURSA	Infective bursitis
M13_INTERVERTEB	Other intervertebral disc disorders
M13_JOINTOTH	Other specific joint derangements/joint disorders
M13_JUVEARTH	Other juvenile arthritis
M13_JUVERHEU	Juvenile rheuma
M13_JUVOSTEOCHONRHIP	Juvenile osteochondrosis
M13_KNEEDERANGEMENTS	Internar derangement of knee
M13_KYPHOSIS	Kyphosis
M13_LATERALEPICOND	Lateral epicondylitis
M13_LIMBLENGTH	Unequal limb length (acquired)
M13_LIMBPAIN	Pain in limb
M13_LOOSEJOINT	Loose body in joint
M13_LOWBACKPAIN	Low back pain
M13_LOWBACKPAINORANDSCIATICA	Lower back pain or/and sciatica
M13_MEDIALEPICOND	Medial epicondylitis
M13_MENISCUSDERANGEMENTS	Meniscus derangement
M13_METATARSALGIA	Metatarsalgia
M13_MONOARTHRITIS	"Monoarthritis, not elsewhere classified"
M13_MULTIFIBRO	Multifocal fibrosclerosis
M13_MUSCLE	Disorders of muscles
M13_MUSCLEATROPH	"Muscle wasting and atrophy, not elsewhere classified"
M13_MUSCLEDISNAS	Other specified disorders of muscle
M13_MUSCLESTRAIN	Muscle strain
M13_MUSCULOSKELEOTH	Other disorders of the musculoskeletal system and connective tissue
M13_MUSCULOSKELETAL	Diseases of the musculoskeletal system and connective tissue
M13_MYALGIA	Myalgia
M13_MYOSITIS	Myositis
M13_NECROVASC	Other necrotizing vasculopathies
M13_NECROVASCNAS	Other specified/unspecified necrotizing vasculopathies
M13_NEURALGIA	"Neuralgia and neuritis, unspecified"
M13_OLECRANONBURSITIS	Olecranon bursitis
M13_OSTEOCHONDRO	Osteopathies and chondropathies
M13_OSTEOCHONDROPATHY	Other osteochondropathies
M13_OSTEOMALACIA	Osteomalacia
M13_OSTEOMYELITIS	Osteomyelitis
M13_OSTEONECROSIS	Osteonecrosis
M13_OSTEOPOROSIS	Osteoporosis
M13_OTHCONN	Other systemic involvement of connective tissue
M13_OTHERBONE	Otherdisorders of bone
M13_OTHERJOINT	Other joint disorders
M13_OVERLAP	Other overlap syndromes
M13_OVERUSENAS	"Other/unspecified soft tissue disorders related to use, overuse and pressure"
M13_PALINDROMIC	Palindromic rheumatism
M13_PANNICULITIS	Panniculitis affecting regions of neck and back
M13_PANNICULITISNAS	"Panniculitis, unspecified"
M13_PATELLADISLOCATIO	Recurrent dislocation of patella
M13_PATELLAOTH	Other disorders of patella
M13_PATELLARTEND	Patellar tendinitis
M13_PATHODISLOCATIO	"Pathological/recurrent dislocation and subluxation of joint, not elsewhere classified"
M13_PERONEALTEND	Peroneal tendinitis
M13_PLANTARFASC	Plantar fascial fibromatosis
M13_POLNODOSA	Polyarteritis nodosa
M13_POLYARTERETAL	Polyarteritis nodosa and related conditions
M13_POLYARTHRITIS	"Polyarthritis, unspecified"
M13_POLYARTHROPATHIES	Polyarthropathies
M13_POLYMYALGIA	Polymyalgia rheumatica
M13_POLYMYO	Polymyositis
M13_POSTOPMUSCULOSKE	"Postprocedural musculoskeletal disorders, not elsewhere classified"
M13_PREPATELLARBURSITIS	Prepatellar bursitis
M13_PSORIARTH	Psoriatic arthropathies
M13_PSORIARTH_ICD10	"Psoriatic arthropathies, ICD10"
M13_PYOGARTH	Pyogenic arthritis
M13_RADICULOPATHY	Radiculopathy
M13_REACTARTH	Reactive arthropathies
M13_RECUDISLOCATIO	Recurrent dislocation and subluxation of joint
M13_RHEUMA	Rheumatoid arthritis
M13_RHEUMATISM	"Rheumatism, unspecified"
M13_RHEUMA_INCLAVO	Rheumatoid arthritis
M13_ROTATORCUFF	Rotator cuff syndrome
M13_SACROCOGG	"Sacrococcygeal disorders, not elsewhere classified"
M13_SACROILIITIS	"Sacroiliitis, not elsewhere classified"
M13_SCIATICA	Siatica+with lumbago
M13_SCOLIOSIS	Scoliosis
M13_SHORTACHILLES	Short Achilles tendon (acquired)
M13_SHOULDER	Shoulder lesions
M13_SHOULDERBURSITIS	Bursitis of shoulder
M13_SHOULDERNAS	Other shoulder lesions
M13_SJOGREN	Sicca syndrome [Sjgren]
M13_SLE	Systemic lupus erythematosus
M13_SOFTOVERUSE	"Soft tissue disorders related to use, overuse and pressure"
M13_SOFTTISSUE	Soft tissue disorders
M13_SOFTTISSUENAS	Other specified/unspecified soft tissue disorders
M13_SOFTTISSUEOTH	"Other soft tissue disorders, not elsewhere classified"
M13_SPINALOSTEOCHON	Spinal osteochondrosis
M13_SPINENTHES	Spinal enthesopathy
M13_SPININSTAB	Spinal instabilities
M13_SPINSTENOSIS	Spinal stenosis
M13_SPONDYLINFLAMNAS	Other specified/unspecified inflammatory spondylopathies
M13_SPONDYLOLISTHESIS	Spondylolisthesis/Spondylolysis
M13_SPONDYLOPATHINOTH	Spondylopathies in diseases classified elsewhere
M13_SPONDYLOPATHY	Spondylopathies
M13_SPONDYLOPATHYNAS	Other specified/unspecified spondylopathies
M13_SPONDYLOSIS	Spondylosis
M13_SPONTRUPTSYNOTEND	Spontaneous rupture of synovium and tendon
M13_SYNOHYPERTROPH	"Synovial hypertrophy, not elsewhere classified"
M13_SYNOTEND	Disorders of synovium and tendon
M13_SYNOTENDINOTH	Disorders of synovium and tendon in diseases classified elsewhere
M13_SYSTCONNECT	Systemic connective tissue disorders
M13_SYSTSLCE	Systemic sclerosis
M13_TEMPARTERIT	Temporal arteritis
M13_TENDOSYNOVITISNAS	Other/unspecified synovitis and tenosynovitis
M13_THORACISPINEPAIN	Pain in thoracic spine
M13_TIBIALCOLLATERAL	Tibial collateral bursitis [Pellegrini-Stieda]
M13_TIETZE	Chondrocostal junction syndrome [Tietze]
M13_TOEDEFORMOTH	Other deformities of toe(s)
M13_TORTICOLLIS	Torticollis
M13_TRANSSYNOVITIS	Transient synovitis
M13_TRIGGERFINGER	Trigger finger
M13_TROCHANTERICBURSITIS	Trochanteric bursitis
M13_VALGUS	"Valgus deformity, not elsewhere classified"
M13_VARUS	"Varus deformity, not elsewhere classified"
M13_VERTEBCOLLAPSE	"Collapsed vertebra, not elsewhere classified"
M13_VILLONODULAR	Villonodular synovitis (pigmented)
M13_WEGENER	Wegener granulomatosis
MACULAR_CYST	Macular cyst
MACULAR_HOLE	Macular hole
MACULAR_PUCKER	Macular pucker
MACULA_NAS	Degenerative macular diseases
MEMLOSS	Memory loss
MENINGITIS	Meningitis
MIGRAINE_TRIPTAN	"Migraine, single triptan purchase ok & required. ICD-code if available is included"
MIGRAINE_UNSPE	"Migraine, unspecified, drug-induced"
MND	Motor neuron disease (with DMD)
MUCOPROCT	Mucosal proctocolitis
MULTIMORB	"Multimorbidity, for COPD"
MYCOBLUNGATYPICA	Atypical mycobacterium lung infection
MYELOPROF	Myeloproliferative diseases
MYELOPROF_NONCML	Myeloproliferative diseases (CML excluded)
N14_ABNORMALBLEED	Other abnormal uterine and caginal bleeding
N14_ACUTENEPHRITIC	Acute nephritic syndrome
N14_ACUTERENFAIL	Acute renal failure
N14_AMENORRHEAPRIM	Amenorrhoea
N14_BARTHOABSCESS	Abscess of Bartholin gland
N14_BARTHOCYS	Cyst of Bartholin Gland
N14_BARTHOOTHNAS	Other and unspecified disease of Bartholin gland
N14_BENIGNMAMDYSP	Benign mammary dysplasia
N14_BREAST	Disorders of breast
N14_BREASTDISOTH	Other disorders of breast
N14_CALCUKIDUR	Calculus of kidney and ureter
N14_CALCULOWER	Calculus of lower urinary tract
N14_CHRONEPHROPATH	Chronic nephritic syndrome
N14_CHRONEPHROPATH_ADVERSE	"Chronic nephritic syndrome, drug-induced"
N14_CHRONKIDNEYDIS	Chronic kidney disease
N14_CHRONTUBULOINTNEPHRITIS	Chronic tubulo-interstitial nephritis
N14_COMPLICARTFERT	Complications associated with artificial fertilization
N14_CYSTITIS	Cystitis
N14_CYSTKID	Cyst of kidney
N14_DIALYSIS	Dialysis
N14_DISIMPAIRRENTUB	Disorders resulting from impaired renal tubular function
N14_DYSPLACERVUT	Dysplasia of cervi uteri
N14_ENDOMETRIOSIS	Endometriosis
N14_ENDOMETRIOSIS_FALLOPIAN_TUBE	Endometriosis of fallopian tube
N14_ENDOMETRIOSIS_INTESTINE	Endometriosis of intestine
N14_ENDOMETRIOSIS_NOS	Unspecified/other endometriosis
N14_ENDOMETRIOSIS_OVARY	Endometriosis of ovary
N14_ENDOMETRIOSIS_PELVICPERITONEUM	Endometriosis of pelvic peritoneum
N14_ENDOMETRIOSIS_RECTPVAGSEPT_VAGINA	Endometriosis of rectovaginal septum and vagina
N14_ENDOMETRIOSIS_UTERUS	Endometriosis of uterus
N14_ENDOMET_INFERT	Endometriosis diagnosis and infertility diagnosis occurring together
N14_EROSECTROPUT	Erosion and ectropion of cervix uteri
N14_FEMALEGENINF	Inflammatory diseases of female pelvic organs
N14_FEMALEGENNONINF	Noninflammatory disorders of female genital tract
N14_FEMALEINFERT	Female infertility
N14_FEMGENFISTUL	Fistulae involving female genital tract
N14_FEMGENPAIN	Pain and other conditions associated with female genital organs and menstrual cycle
N14_FEMGENPROL	Female genital prolapse
N14_FIANOV	"Female infertility, associated with anovulation"
N14_FIOTHNAS	"Female infertility, cervigal, vaginal, other or unspecified origin"
N14_FITUB	"Female infertility, tubal origin"
N14_GENITOURINARY	Genitourinary diseases
N14_GENITOUROTH	Other disorders of the genitourinary system
N14_GLOMEINOTH	Glomerular disorders in diseases classified elsewhere
N14_GLOMERULAR	Glomerular diseases
N14_HABITABORT	Habitual aborter
N14_HYDROCELE	Hydrocele
N14_HYDRONEPHR	Hydronephrosis
N14_HYPERTROPHYBREAST	Hypertrophy of breast
N14_IMPOTENCE	Impotence
N14_INFCERVIX	Inflammatory disease of cervix uteri
N14_INFLAMALEGEN	"Inflammatory disorders of male genital organs, not elsewhere classified"
N14_INFLAMMBREAST	Inflammatory disorders of breast
N14_INFLUTH	Inflammatory disease of uterus
N14_ISOLPROTEINURIA	Isolated proteinuria with specified morphological lesion
N14_ISOLPROTEINURIA_ADVERSE	"Isolated proteinuria with specified morphological lesion, drug-induced"
N14_KIDUROTH	Other disorders of kidney and ureter
N14_LUMPNASBREAST	Unspecified lump in breast
N14_MALEGEN	Diseases of male genital organs
N14_MALEINFERT	Male infertility
N14_MENOPAUSOT	Other menopausal disorders
N14_MESNRUIRREG	"Excessive, freguent and irrelgular menstruation"
N14_NEPHRITICNAS	Unspesified nephritic syndrome
N14_NEPHRITICNAS_ADVERSE	"Unspesified nephritic syndrome, drug-induced"
N14_NEPHROTICSYND	Nephrotic syndrome
N14_NEUROMUSCDYSBLADD	Neuromuscular dysfuntion of bladder
N14_OBSTRUREFLUROPATH	Other obstructive and reflux uropathy
N14_OLIGOMEN	Oligomenorrhoea
N14_ORHCEPINDIDYMITIS	Orchitis and epididymitis
N14_OTHBLADD	Other disorders of  bladder
N14_OTHDISMALEGEN	Other disorders of male genital organs
N14_OTHETNASKIDUR	Other specified disorders of kidney and ureter
N14_OTHFEMPELINF	Other female pelvic inflammatory diseases
N14_OTHINFVAGVULV	Other inflammation of vagina/vulva
N14_OTHNONINFCERVIX	Other noninflammatory disorders of cervix uteri
N14_OTHNONINFOVA	"Other and unspesified noninflammatory disorders of ovary, fallopian tube and broad ligament"
N14_OTHNONINFUTER	"Other noninflammatory disorders of uterus, except cervix"
N14_OTHNONINFVAG	Other noninflammatory disorders of vagina
N14_OTHNONINFVULV	Other noninflammatory disorders of vulva and perineum
N14_OTHPENIS	Other disorders of penis
N14_OVARTORS	"Torsion of ovary, ovarian pedicle and fallobian tube"
N14_OVARYCYST	Ovarian cyst
N14_PHIMOSIS	"Redundant prepuce, phimosis and paraphimosis"
N14_POLYPFEMGEN	Polyp of the female genital tract
N14_POSTMENATRVAG	Postmenopausal atrophic vaginitsi
N14_POSTMENBLEED	Postmenopausal bleeding
N14_PROHERNOV	Prolapse and hernia of ovary and fallopian tube
N14_PROSTAOTH	Other disorders of prostate
N14_PROSTATITIS	Inflammatory diseases of prostate (prostatitis)
N14_PROSTHYPERPLA	Hyperplasia of prostate
N14_PYELONEPHR	Acute tubulo-interstitial nephritis
N14_RECURANDPERHEAMATUR	Recurrent and persistent haematuria
N14_RECURANDPERHEAMATUR_ADVERSE	"Recurrent and persistent haematuria, drug-induced"
N14_RENALTUB	Renal tubulo-intestitial diseases
N14_RENALTUBULOINOTH	Renal tubulo-interstitial disorders in diseases classified elsewhere
N14_RENALTUBULOOTH	Other renal tubulo-interstitial diseases
N14_RENFAIL	Renal failure
N14_RENFAILNAS	Unspesified kidney failure
N14_SALPHOOPH	Salphingitis and oophoritis
N14_SPERMATOCELE	Spermatocele
N14_TORSIOTEST	Torsion of testis
N14_TUBULOINTNEPHRNAS	"Tubulo-interstitial nephritis, not spesified as acute or chronic"
N14_ULCERVAGVUL	Ulcer of vagina/vulva
N14_URETHRALSTRICT	Urethral stricture
N14_URETHRAOTH	Other disorders of urethra and urinary system
N14_URETHRITISANDURSYNDR	Urehtritis and urethral syndrome
N14_URINOTH	Other diseases of urinary system
N14_UROLITHIASIS	Urolithiasis
N14_VAGINITIS	Vaginitis/vulvovaginitis/vulvitis/abscess of vulva
N14_VULVOVAGINFINOTH	Vulvovaginal ulceration/inflammation in other diseases
NAFLD	Nonalcoholic fatty liver disease
NECROVASC_FG	Other necrotizing vasculopathies (FG)
NEPHROPATHY_OPER	Nephropathy related operations
NEURODEGOTH	Other degenerative diseases of the nervous system
NEURODIS	Neurological diseases
NEURO_COMORBIDITIES	Co-morbidities of interest (NEURO)
NIV	Non-invasive ventilation
NONALLERG_ASTHMA	Non-allergic asthma (mode)
NONALLERG_ASTHMA_EXMORE	Non-allergic asthma (mode) (more controls excluded)
O15_ABORT_FAILED	Failed attempted abortion
O15_ABORT_MEDICAL	Medical abortion
O15_ABORT_OTHER	Other abortion
O15_ABORT_SPONTAN	Spontaneous abortion
O15_ABORT_UNS	Unspecified abortion
O15_AMNIOT_OTHER	Other disorders of amniotic fluid and membranes
O15_ANTENAT_ABNORM	Abnormal findings on antenatal screening of mother
O15_ANTEPART_HAEM_NAS	"Antepartum haemorrhage, not elsewhere classified"
O15_BIRTH_BREAT_INFECT	Infections of breast associated with childbirth
O15_BREAST_LACT_OTHER_DIS	Other disorders of breast and lactation associated with childbirth
O15_COMPLIC_ABORT_ECTOP_MOLAR	Complications following abortion and ectopic and molar pregnancy
O15_COMPLIC_LAB_DELIV	Complications of labour and delivery
O15_COMPLIC_PUERP	Complications predominantly related to the puerperium
O15_CONCEPT_ABNORM	Other abnormal products of conception
O15_DELIVERY	Delivery
O15_DELIV_CAESAR	Single delivery by caesarean section
O15_DELIV_FORCEP_VAC	Single delivery by forceps and vacuum extractor
O15_DELIV_MULTIP	Multiple delivery
O15_DELIV_OTHER_ASSIST	Other assisted single delivery
O15_DELIV_PERIN_LACER	Perineal laceration during delivery
O15_DELIV_SPONT	Single spontaneous delivery
O15_ECLAMPSIA	Eclampsia
O15_EXCESS_VOMIT_PREG	Excessive vomiting in pregnancy
O15_EXIST_HYPERT_COMPLIC	"Pre-existing hypertension complicating pregnancy, childbirth and the puerperium"
O15_FAILED_INDUCT	Failed induction of labour
O15_FALSE_LAB	False labour
O15_GESTAT_HYPERT	Gestational [pregnancy-induced] hypertension
O15_GESTAT_OEDEM_PREINUR	Gestational [pregnancy-induced] oedema and proteinuria without hypertension
O15_HAEMORRH_EARLY_PREG	Haemorrhage in early pregnancy
O15_HYPTENSPREG	Pregnancy hypertension
O15_ICP	Intrahepatic Cholestasis of Pregnancy (ICP)Ê
O15_ICP_EXMORE	Intrahepatic Cholestasis of Pregnancy (ICP)Ê (more controls excluded)
O15_ICP_WIDE	"Intrahepatic Cholestasis of Pregnancy (ICP)Ê, incl. ICD-8"
O15_LABOUR_ABNORM_FORCES	Abnormalities of forces of labour
O15_LABOUR_FETAL_STRESS	Labour and delivery complicated by fetal stress [distress]
O15_LABOUR_INTRAPART_HAEMORRH	"Labour and delivery complicated by intrapartum haemorrhage, not elsewhere classified"
O15_LABOUR_LONG	Long labour
O15_LABOUR_MALPOS	Obstructed labour due to malposition and malpresentation of fetus
O15_LABOUR_OBSTR_OTHER	Other obstructed labour
O15_LABOUR_OTHER	"Other complications of labour and delivery, not elsewhere classified"
O15_LABOUR_PELVIC_ABNORM	Obstructed labour due to maternal pelvic abnormality
O15_LABOUR_UMBILICAL	Labour and delivery complicated by umbilical cord complications
O15_MATERN_CARE	Maternal care related to the fetus and amniotic cavity and possible delivery problems
O15_MATERN_CARE_DISPROP	Maternal care for known or suspected disproportion
O15_MATERN_CARE_FETAL_ABNORM	Maternal care for known or suspected fetal abnormality and damage
O15_MATERN_CARE_OTHER	Maternal care for other known or suspected fetal problems
O15_MATERN_CARE_PELVIC_ABNORM	Maternal care for known or suspected abnormality of pelvic organs
O15_MATERN_HYPERT_UNS	Unspecified maternal hypertension
O15_MATERN_INFECT_ELSEWHERE	"Maternal infectious and parasitic diseases classifiable elsewhere but complicating pregnancy, childbirth and  the puerperium"
O15_MAT_CARE_MALPRESENT	Maternal care for known or suspected malpresentation of fetus
O15_MEMBR_PREMAT_RUPT	Premature rupture of membranes
O15_MULTIP_GEST	Multiple gestation
O15_OBSTET_NAS	"Other obstetric conditions, not elsewhere classified"
O15_OBSTET_TRAUMA_OTHER	Other obstetric trauma
O15_OEDEM_PROTUR_HYPERT	"Oedema, proteinuria and hypertensive disorders in pregnancy, childbirth and the puerperium"
O15_OTHER_MATERN_DIS_ELSEWHERE	"Other maternal diseases classifiable elsewhere but complicating pregnancy, childbirth and the puerperium"
O15_PLAC_DISORD	Placental disorders
O15_PLAC_PRAEVIA	Placenta praevia
O15_PLAC_PREMAT_SEPAR	Premature separation of placenta [abruptio placentae]
O15_POLYHYDR	Polyhydramnios
O15_POSTPART_DEPR	Postpartum depression
O15_POSTPART_HEAMORRH	Postpartum haemorrhage
O15_PREECLAMPS	Pre-eclampsia
O15_PREECLAMPS_CHRONIC_HYPERT	Pre-eclampsia superimposed on chronic hypertension
O15_PREG_ABORT	Pregnancy with abortive outcome
O15_PREG_BIRTH_PUERP	"Pregnancy, childbirth and the puerperium"
O15_PREG_DM	Diabetes mellitus in pregnancy
O15_PREG_ECTOP	Ectopic pregnancy
O15_PREG_GU_INFECT	Infections of genitourinary tract in pregnancy
O15_PREG_HYDAT	Hydatidiform mole
O15_PREG_MATERN_CARE	Maternal care for other conditions predominantly related to pregnancy
O15_PREG_OTHER_MAT_DISORD	Other maternal disorders predominantly related to pregnancy
O15_PREG_PROLONGED	Prolonged pregnancy
O15_PREG_VENOUS_HAEMORRH	Venous complications and haemorrhoids in pregnancy
O15_PRETERM	Preterm labour and delivery
O15_PRE_OR_ECLAMPSIA	Pre-eclampsia or eclampsia
O15_PUERP_COMPL_NAS	"Complications of the puerperium, not elsewhere classified"
O15_PUERP_INFECT_OTHER	Other puerperal infections
O15_PUERP_SEPSIS	Puerperal sepsis
O15_RETAINED_PLAC_MEMB_NO_HEAMORRH	"Retained placenta and membranes, without haemorrhage"
O15_VENOUS_COMPLIC	Venous complications and haemorrhoids in the puerperium
OFFICIAL_TILASTOKESKUS	"Alcohol related diseases, tilastokeskus definition"
OPER_ARTIF_JOINT_MENISC_RESECT	"Articial joint operation, menisceal resection"
OPER_ARTIF_JOINT_REOP	Artificial joint re-operation
OPER_COLECTOMY	Colectomy operation
OPER_JFH	Total colectomy
OPER_SFA	Direct fill therapy
OPER_SGA	Opening and dilatation of root channel of tooth
OPER_SGB	Filling of root of tooth
OPER_SGC	Other interventions on the root canals of the tooth
OPER_SHA03	Correction of physiology of bite - demanding therapy visit
OPER_SHA04	Correction of physiology of bite - very demanding therapy visit
OPER_SHB00	Prepation and fitting of bite rail to mouth
OPER_TOTAL_COLECTOMY	Total colectomy operation
OSTEON_DRUGS	Osteonecrosis due to drugs
OSTEOPOROSIS_FRACTURE_FG	Osteoporosis with pathological fracture (FG)
OSTPOPATFRACTURE	Drug-induced osteoporosis with pathological fracture
OSTPOPATFRCTURE_POSTEMENO	Postmenopausal osteoporosis with pathological fracture
OTHER_DRUGADVERS_SECONDA_PARKINSONI	Other drug-induced secondary parkinsonism
OTHER_ILD_CVD_COMORB	Other ILD-related CVD-co-morbidities
OTHER_SYSTCON_FG	Other systemic involvement of connective tissue (FG)
P16_DIGES_SYSTEM_DISORD_FETUS_NEWBO	Digestive system disorders of fetus and newborn
P16_DISORD_RELATED_GESTATION_LOW_BIRTHWGHTT_NECIFIED	"Disorders related to short gestation and low birth weight, not elsewhere classified"
P16_DISORD_RELATED_LENGTH_GESTATION_FETAL_GROWTH	Disorders related to length of gestation and fetal growth
P16_FET_NEWB_MATERN_FACTO_COMPLICATIO_PREGNAC_LABOUR_DELIV	"Fetus and newborn affected by maternal factors and by complications of pregnancy, labour and delivery"
P16_HAEMORRHAGIC_HAEMATOL_DISORD_FETUS_NEWBO	Haemorrhagic and haematological disorders of fetus and newborn
P16_INFECTIONS_SPECIFIC_PERINA_PERIOD	Infections specific to the perinatal period
P16_MECONIUMI_CAUSED_CYSTIC_FIBROSIS	Meconiumileus caused by cystic fibrosis
P16_NEONTAL_JAUND_OTH_UNSP_CAUSES	Neonatal jaundice from other and unspecified causes
P16_OTH_DISORD_ORIGINA_PERINA_PERIOD	Other disorders originating in the perinatal period
P16_RESPI_CARDIOV_DISORD_SPECIFIC_PERINA_PERIOD	Respiratory and cardiovascular disorders specific to the perinatal period
P16_RESPI_DISTR_NEWBO	Respiratory distress of newborn
P16_TRANSITO_DISORD_CARBOH_METABOLISM_SPECIFIC_FETUS_NEWBO	Transitory disorders of carbohydrate metabolism specific to fetus and newborn
P16_TRANSITO_ENDOCR_METABOLIC_DISORD_SPECIFIC_FETUS_NEWBO	Transitory endocrine and metabolic disorders specific to fetus and newborn
PACEMAKER	Pacemaker
PAIN	"Pain (limb, back, neck, head abdominally)"
PANCREATITIS	Acute pancreatis (for exclusion)
PAR	Peripheral arterial reconstruction
PD2ND	Secondary parkinsonism
PD2ND_EXMORE	Secondary parkinsonism (more controls excluded)
PDSTRICT	"Parkinson's disease, strict definition"
PDSTRICT_EXMORE	"Parkinson's disease, strict definition" (more controls excluded)
PD_DEMENTIA	Dementia due to Parkinsons disease
PD_DEMENTIA_EXMORE	Dementia due to Parkinsons disease (more controls excluded)
PHLEBI_THROMBOP_LOWER_EXTREMITI_UNSPE	"Phlebitis and thrombophlebitis of lower extremities, unspecified, drug-induced"
PNEUMOBACTKNOWN	Bacterial pneumonia (organism specified)
PNEUMONIA	Pneumonias (Asthma/COPD co-morbidities)
PNEUMO_SEPTHICHE	Pneumococcal septichemia
POLLENALLERG	Pollen allergy
POLYCYTVERA	Polycythaemia vera
POLYPECTOMY	Polypectomy (DHB20)
PRIM_COXARTHROSIS	"Primary coxarthrosis, bilateral"
PRIM_KNEEARTHROSIS	"Primary gonarthrosis, bilateral"
PSORI_STRICT	"Psoriasis (vulgaris), strict definition"
PSOR_ARTHR_OTH	Other psoriatic arthropathies
PSOR_ENTE_ARTHR	Psoriatic and enteropathic arthropathies
PULMONARYDG	Other pulmonary diagnosis
PULM_ANXIETY	Anxiety (asthma-related co-morbidities)
PULM_IMMUNECOMORB	Immune disease comorbidities
PULM_INFECTIONS	COPD/asthma/ILD related infections
PULM_MEDICATIO_COMORB	Medication related adverse effects (Asthma/COPD)
PULM_PNEUMONIA_SEPSIS	COPD/asthma/ILD related pneumonia or pneumonia derived septichaemia
PULM_PSYCH_COMORB	Psychiatric comorbidites (Asthma/COPD)
Q17_ANKYLOGLOSSIA	Ankyloglossia
Q17_CHEFT_HARD_PALATE_NOS	Cheft hard palate NOS
Q17_CHROMOSOMAL_ABNORMALITI_NOT_ELSEW_CLASSIFIED	"Chromosomal abnormalities, not elsewhere classified"
Q17_CLEFT_AND_CARIES	Clefts and caries
Q17_CLEFT_HARD_PALATE_W_CLEFT_LIP_UNILA	"Cleft hard palate with cleft lip, unilateral"
Q17_CLEFT_LIP_CLEFT_PALATE	Cleft lip and cleft palate
Q17_CLEFT_PALATE	Cleft palate
Q17_CL_AND_CLP	CL and CLP
Q17_CONGEN_DEFORMITI_FEET	Congenital deformities of feet
Q17_CONGEN_DEFORMITI_HIP	Congenital deformities of hip
Q17_CONGEN_MALFO_ANTER_SEGMENT_EYE	Congenital malformations of anterior segment of eye
Q17_CONGEN_MALFO_AORTIC_MITRAL_VALVES	Congenital malformations of aortic and mitral valves
Q17_CONGEN_MALFO_BREAST	Congenital malformations of breast
Q17_CONGEN_MALFO_CARDIAC_CHAMB_CONNECTIO	Congenital malformations of cardiac chambers and connections
Q17_CONGEN_MALFO_CARDIAC_SEPTA	Congenital malformations of cardiac septa
Q17_CONGEN_MALFO_CIRCULATO_SYSTEM	Congenital malformations of the circulatory system
Q17_CONGEN_MALFO_DEFORMAT_MUSCULOS_SYSTEM	Congenital malformations and deformations of the musculoskeletal system
Q17_CONGEN_MALFO_EYELID_LACRIMAL_APPARA_ORBIT	"Congenital malformations of eyelid, lacrimal apparatus and orbit"
Q17_CONGEN_MALFO_EYE_EAR_FACE_NECK	"Congenital malformations of eye, ear, face and neck"
Q17_CONGEN_MALFO_GALLB_BILE_DUCTS_LIVER	"Congenital malformations of gallbladder, bile ducts and liver"
Q17_CONGEN_MALFO_GENITAL_ORGANS	Congenital malformations of genital organs
Q17_CONGEN_MALFO_GREAT_ARTERIES	Congenital malformations of great arteries
Q17_CONGEN_MALFO_MUSCULOS_SYSTEM_NOT_ELSEW_CLASSIFIED	"Congenital malformations of the musculoskeletal system, not elsewhere classified"
Q17_CONGEN_MALFO_NERVOUS_SYSTEM	Congenital malformations of the nervous system
Q17_CONGEN_MALFO_OVARIES_FALLOP_TUBES_BROAD_LIGAM	"Congenital malformations of ovaries, fallopian tubes and broad ligaments"
Q17_CONGEN_MALFO_PULMONARY_TRICU_VALVES	Congenital malformations of pulmonary and tricuspid valves
Q17_CONGEN_MALFO_RESPI_SYSTEM	Congenital malformations of the respiratory system
Q17_CONGEN_MALFO_SPINE_BONY_THORAX	Congenital malformations of spine and bony thorax
Q17_CONGEN_MALFO_TRACHEA_BRONCHUS	Congenital malformations of trachea and bronchus
Q17_CONGEN_MALFO_URINARY_SYSTEM	Congenital malformations of the urinary system
Q17_CONGEN_MALFO_UTERUS_CERVIX	Congenital malformations of uterus and cervix
Q17_CONGEN_MUSCULOS_DEFORMITI_HEAD_FACE_SPINE_CHEST	"Congenital musculoskeletal deformities of head, face, spine and chest"
Q17_CONGEN_OBSTRUCTIVE_DEFECTS_RENAL_PELVIS_CONGEN_MALFO_URETER	Congenital obstructive defects of renal pelvis and congenital malformations of ureter
Q17_CRANIOSYNOSTOSIS	Craniosynostosis
Q17_CYSTIC_KIDNEY_DISEA	Cystic kidney disease
Q17_EHLER_SYNDR	Ehlers-Danlos syndrome
Q17_OTHER_CONGEN_MALFO	Other congenital malformations
Q17_OTHER_CONGEN_MALFO_CIRCULATO_SYSTEM	Other congenital malformations of circulatory system
Q17_OTHER_CONGEN_MALFO_DIGES_SYSTEM1	Other congenital malformations of the digestive system
Q17_OTHER_CONGEN_MALFO_EAR	Other congenital malformations of ear
Q17_OTHER_CONGEN_MALFO_FACE_NECK	Other congenital malformations of face and neck
Q17_OTHER_CONGEN_MALFO_FEMALE_GENITALIA	Other congenital malformations of female genitalia
Q17_OTHER_CONGEN_MALFO_HEART	Other congenital malformations of heart
Q17_OTHER_CONGEN_MALFO_INTESTINE	Other congenital malformations of intestine
Q17_OTHER_CONGEN_MALFO_LIMBS	Other congenital malformations of limb(s)
Q17_OTHER_CONGEN_MALFO_MALE_GENITAL_ORGANS	Other congenital malformations of male genital organs
Q17_OTHER_CONGEN_MALFO_NERVOUS_SYSTEM	Other congenital malformations of nervous system
Q17_OTHER_CONGEN_MALFO_NOT_ELSEW_CLASSIFIED	"Other congenital malformations, not elsewhere classified"
Q17_OTHER_CONGEN_MALFO_PERIP_VASCULAR_SYSTEM	Other congenital malformations of peripheral vascular system
Q17_OTHER_CONGEN_MALFO_SKIN	Other congenital malformations of skin
Q17_OTHER_CONGEN_MALFO_TONGUE_MOUTH_PHARYNX	"Other congenital malformations of tongue, mouth and pharynx"
Q17_OTHER_OSTEOCHONDROD	Other osteochondrodysplasias
Q17_OTHER_SPECIFE_CONGEN_MALFO_SYNDR_AFFECTING_MULTIPLE_SYSTEMS	Other specified congenital malformation syndromes affecting multiple systems
Q17_PHAKOMATOSES_NOT_ELSEW_CLASSIFIED	"Phakomatoses, not elsewhere classified"
Q17_UNDES_TESTICLE	Undescended testicle
R18_ABDOMI_PELVIC_PAIN	Abdominal and pelvic pain
R18_ABNORMALITI_BREAT	Abnormalities of breathing
R18_ABNORMALITI_GAIT_MOBIL	Abnormalities of gait and mobility
R18_ABNORMALITI_HEART_BEAT	Abnormalities of heart beat
R18_ABNORMAL_BLOOD_P_READI_WO_DIAGNOSIS	"Abnormal blood-pressure reading, without diagnosis"
R18_ABNORMAL_FINDI_DIAGNOST_IMAGI_BREAST	Abnormal findings on diagnostic imaging of breast
R18_ABNORMAL_FINDI_DIAGNOST_IMAGI_CENTRAL_NERVOUS_SYSTEM	Abnormal findings on diagnostic imaging of central nervous system
R18_ABNORMAL_FINDI_DIAGNOST_IMAGI_FUNCTION_STUDI_WO_DIAGNOSIS	"Abnormal findings on diagnostic imaging and in function studies, without diagnosis"
R18_ABNORMAL_FINDI_DIAGNOST_IMAGI_LUNG	Abnormal findings on diagnostic imaging of lung
R18_ABNORMAL_FINDI_DIAGNOST_IMAGI_OTHER_BODY_STRUCTURES	Abnormal findings on diagnostic imaging of other body structures
R18_ABNORMAL_FINDI_EXAMI_BLOOD_WO_DIAGNOSIS	"Abnormal findings on examination of blood, without diagnosis"
R18_ABNORMAL_FINDI_EXAMI_OTHER_BODY_FLUIDS_SUBST_TISSU_WO_DIAGNOSIS	"Abnormal findings on examination of other body fluids, substances and tissues, without diagnosis"
R18_ABNORMAL_FINDI_EXAMI_URINE_WO_DIAGNOSIS	"Abnormal findings on examination of urine, without diagnosis"
R18_ABNORMAL_FINDI_NIPPLE_DISCH_SYNOVIAL_FLUID_WOUND_SECRE	Abnormal findings in nipple discharge synovial fluid wound secretions
R18_ABNORMAL_FINDI_SECRE_SMEARS_CERVIX_UTERI_VAGINA_VULVA	Abnormal findings in secretions and smears from cervix uteri vagina vulva
R18_ABNORMAL_INVOLU_MOVEM	Abnormal involuntary movements
R18_ABNORMAL_RESULTS_FUNCTION_STUDI	Abnormal results of function studies
R18_ABNORMAL_SERUM_ENZYME_LEVELS	Abnormal serum enzyme levels
R18_ABNORMAL_SPERMATOZ	Abnormal spermatozoa
R18_ABNORMAL_WEIGHT_LOSS	Abnormal weight loss
R18_ANOREXIA	Anorexia
R18_ANURIA_OLIGU	Anuria and oliguria
R18_ASCITES	Ascites
R18_CARDIAC_MURMU_OTHER_CARDIAC_SOUNDS	Cardiac murmurs and other cardiac sounds
R18_CONVU_NOT_ELSEW_CLASSIFIED	"Convulsions, not elsewhere classified"
R18_COUGH	Cough
R18_CRAMP_SPASM	Cramp and spasm
R18_DISTU_SKIN_SENSA	Disturbances of skin sensation
R18_DISTU_SMELL_TASTE	Disturbances of smell and taste
R18_DIZZI_GIDDI	Dizziness and giddiness
R18_DYSPHAGIA	Dysphagia
R18_DYSPNOEA	Dyspnoea
R18_ELEVATED_BLOOD_GLUCOSE_LEVEL	Elevated blood glucose level
R18_ELEVATED_ERYTHROCYTE_SEDIM_RATE_ABNORMALITY_PLASMA_VISCO	Elevated erythrocyte sedimentation rate and abnormality of plasma viscosity
R18_ENLARGED_LYMPH_NODES	Enlarged lymph nodes
R18_FAECAL_INCONTINENCE	Faecal incontinence
R18_FASCICULATION	Fasciculation
R18_FEVER_OTHER_UNKNO_ORIGIN	Fever of other and unknown origin
R18_FLATU_RELATED_CONDI	Flatulence and related conditions
R18_GANGRENE_NOT_ELSEW_CLASSIFIED	"Gangrene, not elsewhere classified"
R18_GENERAL_SYMPTOMS_SIGNS	General symptoms and signs
R18_HAEMORRHAGE_NOT_ELSEW_CLASSIFIED	"Haemorrhage, not elsewhere classified"
R18_HAEMORRHAGE_RESPI_PASSA	Haemorrhage from respiratory passages
R18_HEADACHE1	Headache
R18_HEARTBURN	Heartburn
R18_HEPATOM_SPLENO_NOT_ELSEW_CLASSIFIED	"Hepatomegaly and splenomegaly, not elsewhere classified"
R18_HYPERHIDROSIS	Hyperhidrosis
R18_ILL_D_UNKNO_CAUSES_MORTA	Ill-defined and unknown causes of mortality
R18_ISOLATED_PROTEINU	Isolated proteinuria
R18_LACK_EXPEC_NORMAL_PHYSIO_DEVELOPMENT	Lack of expected normal physiological development
R18_LOCALIZED_SWELL_MASS_LUMP_SKIN_SUBCU_TISSUE	"Localized swelling, mass and lump of skin and subcutaneous tissue"
R18_MALAI_FATIG	Malaise and fatigue
R18_MOUTH_BREAT	Mouth breathing
R18_NAUSEA_VOMITI	Nausea and vomiting
R18_OEDEMA_NOT_ELSEW_CLASSIFIED	"Oedema, not elsewhere classified"
R18_OTHER_ABNORMALITI_PLASMA_PROTEINS	Other abnormalities of plasma proteins
R18_OTHER_ABNORMAL_FINDI_BLOOD_CHEMIS	Other abnormal findings of blood chemistry
R18_OTHER_ABNORMAL_FINDI_URINE	Other abnormal findings in urine
R18_OTHER_ABNORMAL_IMMUNOL_FINDI_SERUM	Other abnormal immunological findings in serum
R18_OTHER_GENERAL_SYMPTOMS_SIGNS	Other general symptoms and signs
R18_OTHER_ILL_D_UNSPE_CAUSES_MORTA	Other ill-defined and unspecified causes of mortality
R18_OTHER_LACK_COORD	Other lack of coordination
R18_OTHER_SKIN_CHANG	Other skin changes
R18_OTHER_SYMPTOMS_SIGNS_INVOLVI_CIRCULATO_RESPI_SYSTEMS	Other symptoms and signs involving the circulatory and respiratory systems
R18_OTHER_SYMPTOMS_SIGNS_INVOLVI_COGNITIVE_FUNCTIONS_AWARE	Other symptoms and signs involving cognitive functions and awareness
R18_OTHER_SYMPTOMS_SIGNS_INVOLVI_DIGES_SYSTEM_ABDOMEN	Other symptoms and signs involving the digestive system and abdomen
R18_OTHER_SYMPTOMS_SIGNS_INVOLVI_GENERAL_SENSA_PERCEP	Other symptoms and signs involving general sensations and perceptions
R18_OTHER_SYMPTOMS_SIGNS_INVOLVI_NERVOUS_MUSCULOS_SYSTEMS	Other symptoms and signs involving the nervous and musculoskeletal systems
R18_OTHER_SYMPTOMS_SIGNS_INVOLVI_URINARY_SYSTEM	Other symptoms and signs involving the urinary system
R18_PAIN_ASSOCIATED_W_MICTU	Pain associated with micturition
R18_PAIN_NOT_ELSEW_CLASSIFIED	"Pain, not elsewhere classified"
R18_PAIN_THROAT_CHEST	Pain in throat and chest
R18_POLYURIA	Polyuria
R18_RASH_OTHER_NONSPECIFIC_SKIN_ERUPT	Rash and other nonspecific skin eruption
R18_RETEN_URINE	Retention of urine
R18_SENILITY	Senility
R18_SHOCK_NOT_ELSEW_CLASSIFIED	"Shock, not elsewhere classified"
R18_SOMNOLENCE	Somnolence
R18_SOMNO_STUPOR_COMA	"Somnolence, stupor and coma"
R18_SPEECH_DISTU_NOT_ELSEW_CLASSIFIED	"Speech disturbances, not elsewhere classified"
R18_SYMPTOMS_SIGNS_CONCERNI_FOOD_FLUID_INTAKE	Symptoms and signs concerning food and fluid intake
R18_SYMPTOMS_SIGNS_INVOLVI_APPEA_BEHVI	Symptoms and signs involving appearance and behaviour
R18_SYMPTOMS_SIGNS_INVOLVI_CIRCULATO_RESPI_SYSTEMS	Symptoms and signs involving the circulatory and respiratory systems
R18_SYMPTOMS_SIGNS_INVOLVI_COGNITION_PERCEP_EMOTIONAL_STATE_BEHVI	"Symptoms and signs involving cognition, perception, emotional state and behaviour"
R18_SYMPTOMS_SIGNS_INVOLVI_DIGES_SYSTEM_ABDOMEN	Symptoms and signs involving the digestive system and abdomen
R18_SYMPTOMS_SIGNS_INVOLVI_EMOTIONAL_STATE	Symptoms and signs involving emotional state
R18_SYMPTOMS_SIGNS_INVOLVI_NERVOUS_MUSCULOS_SYSTEMS	Symptoms and signs involving the nervous and musculoskeletal systems
R18_SYMPTOMS_SIGNS_INVOLVI_SKIN_SUBCU_TISSUE	Symptoms and signs involving the skin and subcutaneous tissue
R18_SYMPTOMS_SIGNS_INVOLVI_SPEECH_VOICE	Symptoms and signs involving speech and voice
R18_SYMPTOMS_SIGNS_INVOLVI_URINARY_SYSTEM	Symptoms and signs involving the urinary system
R18_SYNCO_COLLAP	Syncope and collapse
R18_UNKNO_UNSPE_CAUSES_MORBIDI	Unknown and unspecified causes of morbidity
R18_UNSPE_HAEMATU	Unspecified haematuria
R18_UNSPE_JAUND	Unspecified jaundice
R18_UNSPE_URINARY_INCONTINENCE	Unspecified urinary incontinence
R18_VOICE_DISTU	Voice disturbances
RA_CO_MORB	Rheumatoid arthritis -related co-morbidities
REAC_ARTHRO_NOS	Other/unspecified reactive arthropathies
RESPIRATORYINSUFF	Respiratory insufficiency
RESP_ILL_DIS_CLASS_ELSEWHERE	Respiratory disorders in diseases classified elsewhere
RHEUMA_ARHTROPAT_REACTIVE	"Reactive arthropathies, FINNGEN"
RHEUMA_CHRYSTAL	"Chrystal arthropathies, rheuma endpoint"
RHEUMA_COMORB	Rheumatological diseases related comorbidities
RHEUMA_ENDPOINTS	Finngen Rheumatological endpoints
RHEUMA_NOS	Other/unspecified rheumatoid arthritis
RHEUMA_OTHER_WIDE	"Other (seronegative) rheumatoid arthritis, wide"
RHEUMA_SERONEG	Seronegative rheumatoid arthritis
RHEUMA_SEROPOS	Seropositive rheumatoid arthritis
RHEUMA_SEROPOS_OTH	Other/unspecified seropositiverheumatoid arthritis
RHEUMA_SEROPOS_OTH_ICD10	Other/unspecified seropositiverheumatoid arthritis (ICD-10)
RHEUMA_SEROPOS_STRICT	"Seropositive rheumatoid arthritis, strict definition"
RHEUMA_SEROPOS_WIDE	"Seropositive rheumatoid arthritis, wide"
RHEU_ARTHRITIS_OTH	Other arthritis (FG)
RHINITIS_VASOMOTOR	Vasomotor rhinitis (mode)
RX_ANTIHYP	Antihypertensive medication - note that there are other indications
RX_CODEINE_TRAMADOL	Codeine or tramadol medication
RX_CROHN_1STLINE	First line medication for Crohns disease
RX_CROHN_2NDLINE	Second line medication for Crohns disease
RX_GLUCOSAMINE	Glucosamine medication
RX_INFERTILITY	Medical treatment for female infertility
RX_PARACETAMOL_NSAID	Paracetamol of NSAID medication
RX_RHEUMA_BIOLOGICAL	Biological medication for rheuma
RX_STATIN	Statin medication
SCND_OTH_COXARTHROSIS	Other secondary coxarthrosis
SCND_OTH_KNEEARTHROSIS	Other secondary gonarthrosis
SEPTICHE_PNEUMONIA	Pneumonia derived septichemia
SFN	Small fibre neuropathy
SLEEP	Sleep disorders (combined)
SLE_COMORB	SLE-related co-morbidities
SLE_FG	SLE (Finngen)
SLE_ICD10	"SLE, ICD10"
SLE_NOS	"Systemic lupus erythematosus, unspecified"
SLE_OTH	Other forms of systemic lupus erythematosus
SLE_STRICT	"SLE, strict definition"
SMOKING	Smoking
SMOKING_DEPEND	Smoking dependancy
SPONDYLOARTHRITIS	Spondyloarthritis
SPONDYLOPATHY_FG	Spondylopathies (FG)
SPONDYLOPATH_COMORB	Spondylopathy related co-morbidities
ST19_ADVER_EFFEC_NOT_ELSEW_CLASSIFIED	"Adverse effects, not elsewhere classified"
ST19_ALIQU_COMPLICATI_PRAECO_TRAUMAT	!Aliquae complicationes praecoces traumatis
ST19_BURNS_CLASSIFIED_ACCOR_EXTENT_BODY_SURFA_INVOLVED	Burns classified according to extent of body surface involved
ST19_BURNS_CORROSIO	Burns and corrosions
ST19_BURNS_CORROSIO_CONFIN_EYE_INTERNAL_ORGANS	Burns and corrosions confined to eye and internal organs
ST19_BURNS_CORROSIO_EXTER_BODY_SURFA_SPECIFE_SITE	"Burns and corrosions of external body surface, specified by site"
ST19_BURNS_CORROSIO_MULTIPLE_BODY_REGIONS	Burns and corrosions of multiple body regions
ST19_BURNS_CORROSIO_MULTIPLE_UNSPE_BODY_REGIONS	Burns and corrosions of multiple and unspecified body regions
ST19_BURN_CORROSION_ANKLE_FOOT	Burn and corrosion of ankle and foot
ST19_BURN_CORROSION_CONFIN_EYE_ADNEXA	Burn and corrosion confined to eye and adnexa
ST19_BURN_CORROSION_HEAD_NECK	Burn and corrosion of head and neck
ST19_BURN_CORROSION_HIP_LOWER_LIMB_ANKLE_FOOT	"Burn and corrosion of hip and lower limb, except ankle and foot"
ST19_BURN_CORROSION_SHOUL_UPPER_LIMB_WRIST_HAND	"Burn and corrosion of shoulder and upper limb, except wrist and hand"
ST19_BURN_CORROSION_TRUNK	Burn and corrosion of trunk
ST19_BURN_CORROSION_WRIST_HAND	Burn and corrosion of wrist and hand
ST19_COMPLICATIO_CARDIAC_VASCULAR_PROSTHET_DEVICES_IMPLANTS_GRAFTS	"Complications of cardiac and vascular prosthetic devices, implants and grafts"
ST19_COMPLICATIO_FOLLOWI_INFUS_TRANSFU_THERAPE_INJEC	"Complications following infusion, transfusion and therapeutic injection"
ST19_COMPLICATIO_GENITO_PROSTHET_DEVICES_IMPLANTS_GRAFTS	"Complications of genitourinary prosthetic devices, implants and grafts"
ST19_COMPLICATIO_INTERNAL_ORTHOPA_PROSTHET_DEVICES_IMPLANTS_GRAFTS	"Complications of internal orthopaedic prosthetic devices, implants and grafts"
ST19_COMPLICATIO_OTHER_INTERNAL_PROSTHET_DEVICES_IMPLANTS_GRAFTS	"Complications of other internal prosthetic devices, implants and grafts"
ST19_COMPLICATIO_PECUL_REATTACHM_AMPUT	Complications peculiar to reattachment and amputation
ST19_COMPLICATIO_PROCED_NOT_ELSEW_CLASSIFIED	"Complications of procedures, not elsewhere classified"
ST19_COMPLICATIO_SURGI_MEDICAL_CARE_NOT_ELSEW_CLASSIFIED	"Complications of surgical and medical care, not elsewhere classified"
ST19_CONCUSSION	Concussion
ST19_CONTU_ANKLE	Contusion of ankle
ST19_CONTU_OTHER_UNSPE_PARTS_FOOT	Contusion of other and unspecified parts of foot
ST19_CONTU_TOES_WO_DAMAGE_NAIL	Contusion of toe(s) without damage to nail
ST19_CONTU_TOES_W_DAMAGE_NAIL	Contusion of toe(s) with damage to nail
ST19_CRUSHI_INJURY_WRIST_HAND	Crushing injury of wrist and hand
ST19_DIFFU_BRAIN_INJURY	Diffuse brain injury
ST19_DISLO_SPRAIN_STRAIN_JOINTS_LIGAM_ANKLE_FOOT_LEVEL	"Dislocation, sprain and strain of joints and ligaments at ankle and foot level"
ST19_DISLO_SPRAIN_STRAIN_JOINTS_LIGAM_ELBOW	"Dislocation, sprain and strain of joints and ligaments of elbow"
ST19_DISLO_SPRAIN_STRAIN_JOINTS_LIGAM_HEAD	"Dislocation, sprain and strain of joints and ligaments of head"
ST19_DISLO_SPRAIN_STRAIN_JOINTS_LIGAM_KNEE	"Dislocation, sprain and strain of joints and ligaments of knee"
ST19_DISLO_SPRAIN_STRAIN_JOINTS_LIGAM_LUMBAR_SPINE_PELVIS	"Dislocation, sprain and strain of joints and ligaments of lumbar spine and pelvis"
ST19_DISLO_SPRAIN_STRAIN_JOINTS_LIGAM_NECK_LEVEL	"Dislocation, sprain and strain of joints and ligaments at neck level"
ST19_DISLO_SPRAIN_STRAIN_JOINTS_LIGAM_SHOUL_GIRDLE	"Dislocation, sprain and strain of joints and ligaments of shoulder girdle"
ST19_DISLO_SPRAIN_STRAIN_JOINTS_LIGAM_THORAX	"Dislocation, sprain and strain of joints and ligaments of thorax"
ST19_DISLO_SPRAIN_STRAIN_JOINTS_LIGAM_WRIST_HAND_LEVEL	"Dislocation, sprain and strain of joints and ligaments at wrist and hand level"
ST19_DISLO_SPRAIN_STRAIN_JOINT_LIGAM_HIP	"Dislocation, sprain and strain of joint and ligaments of hip"
ST19_EARLY_COMPLICATIO_TRAUMA	Early complications of trauma
ST19_EFFEC_FOREI_BODY_ENTERING_NATURAL_ORIFI	Effects of foreign body entering through natural orifice
ST19_EFFEC_HEAT_LIGHT	Effects of heat and light
ST19_EFFEC_OTHER_EXTER_CAUSES	Effects of other external causes
ST19_EPIDU_HAEMORRHAGE	Epidural haemorrhage
ST19_FAILU_REJEC_TRANSPLANTED_ORGANS_TISSU	Failure and rejection of transplanted organs and tissues
ST19_FOCAL_BRAIN_INJURY	Focal brain injury
ST19_FOREI_BODY_ALIME_TRACT	Foreign body in alimentary tract
ST19_FOREI_BODY_EAR	Foreign body in ear
ST19_FOREI_BODY_EXTER_EYE	Foreign body on external eye
ST19_FOREI_BODY_GENITO_TRACT	Foreign body in genitourinary tract
ST19_FOREI_BODY_RESPI_TRACT	Foreign body in respiratory tract
ST19_FRACT_FEMUR	Fracture of femur
ST19_FRACT_FOOT_ANKLE	"Fracture of foot, except ankle"
ST19_FRACT_FOREA	Fracture of forearm
ST19_FRACT_LOWER_LEG_INCLU_ANKLE	"Fracture of lower leg, including ankle"
ST19_FRACT_LUMBAR_SPINE_PELVIS	Fracture of lumbar spine and pelvis
ST19_FRACT_NECK	Fracture of neck
ST19_FRACT_RIBS_STERNUM_THORACIC_SPINE	"Fracture of rib(s), sternum and thoracic spine"
ST19_FRACT_SHOUL_UPPER_ARM	Fracture of shoulder and upper arm
ST19_FRACT_SKULL_FACIAL_BONES	Fracture of skull and facial bones
ST19_FRACT_WRIST_HAND_LEVEL	Fracture at wrist and hand level
ST19_FROSTBITE	Frostbite
ST19_HYPOTHERMIA	Hypothermia
ST19_ICTRAUOTHUNS	Other and unspecified intracranial injuries
ST19_INJURI_ABDOMEN_LOWER_BACK_LUMBAR_SPINE_PELVIS	"Injuries to the abdomen, lower back, lumbar spine and pelvis"
ST19_INJURI_ANKLE_FOOT	Injuries to the ankle and foot
ST19_INJURI_ELBOW_FOREA	Injuries to the elbow and forearm
ST19_INJURI_HEAD	Injuries to the head
ST19_INJURI_HIP_THIGH	Injuries to the hip and thigh
ST19_INJURI_INVOLVI_MULTIPLE_BODY_REGIONS	Injuries involving multiple body regions
ST19_INJURI_KNEE_LOWER_LEG	Injuries to the knee and lower leg
ST19_INJURI_NECK	Injuries to the neck
ST19_INJURI_SHOUL_UPPER_ARM	Injuries to the shoulder and upper arm
ST19_INJURI_THORAX	Injuries to the thorax
ST19_INJURI_UNSPE_PART_TRUNK_LIMB_BODY_REGION	"Injuries to unspecified part of trunk, limb or body region"
ST19_INJURI_WRIST_HAND	Injuries to the wrist and hand
ST19_INJURY_BLOOD_VESSE_WRIST_HAND_LEVEL	Injury of blood vessels at wrist and hand level
ST19_INJURY_CRANIAL_NERVES	Injury of cranial nerves
ST19_INJURY_EYE_ORBIT	Injury of eye and orbit
ST19_INJURY_INTRA_AB_ORGANS	Injury of intra-abdominal organs
ST19_INJURY_MUSCLE_TENDON_ANKLE_FOOT_LEVEL	Injury of muscle and tendon at ankle and foot level
ST19_INJURY_MUSCLE_TENDON_FOREA_LEVEL	Injury of muscle and tendon at forearm level
ST19_INJURY_MUSCLE_TENDON_HIP_THIGH_LEVEL	Injury of muscle and tendon at hip and thigh level
ST19_INJURY_MUSCLE_TENDON_LOWER_LEG_LEVEL	Injury of muscle and tendon at lower leg level
ST19_INJURY_MUSCLE_TENDON_SHOUL_UPPER_ARM_LEVEL	Injury of muscle and tendon at shoulder and upper arm level
ST19_INJURY_MUSCLE_TENDON_WRIST_HAND_LEVEL	Injury of muscle and tendon at wrist and hand level
ST19_INJURY_NERVES_ANKLE_FOOT_LEVEL	Injury of nerves at ankle and foot level
ST19_INJURY_NERVES_FOREA_LEVEL	Injury of nerves at forearm level
ST19_INJURY_NERVES_LOWER_LEG_LEVEL	Injury of nerves at lower leg level
ST19_INJURY_NERVES_SHOUL_UPPER_ARM_LEVEL	Injury of nerves at shoulder and upper arm level
ST19_INJURY_NERVES_SPINAL_CORD_NECK_LEVEL	Injury of nerves and spinal cord at neck level
ST19_INJURY_NERVES_WRIST_HAND_LEVEL	Injury of nerves at wrist and hand level
ST19_INJURY_OTHER_UNSPE_INTRAT_ORGANS	Injury of other and unspecified intrathoracic organs
ST19_INJURY_UNSPE_BODY_REGION	Injury of unspecified body region
ST19_INJURY_URINARY_PELVIC_ORGANS	Injury of urinary and pelvic organs
ST19_INTRACRATRAUMA	Intracranial trauma
ST19_INTRACR_INJURY	Intracranial injury
ST19_MALTR_SYNDR	Maltreatment syndromes
ST19_OPEN_WOUND_ABDOMEN_LOWER_BACK_PELVIS	"Open wound of abdomen, lower back and pelvis"
ST19_OPEN_WOUND_ANKLE_FOOT	Open wound of ankle and foot
ST19_OPEN_WOUND_FOREA	Open wound of forearm
ST19_OPEN_WOUND_HEAD	Open wound of head
ST19_OPEN_WOUND_HIP_THIGH	Open wound of hip and thigh
ST19_OPEN_WOUND_LOWER_LEG	Open wound of lower leg
ST19_OPEN_WOUND_NECK	Open wound of neck
ST19_OPEN_WOUND_SHOUL_UPPER_ARM	Open wound of shoulder and upper arm
ST19_OPEN_WOUND_THORAX	Open wound of thorax
ST19_OPEN_WOUND_WRIST_HAND	Open wound of wrist and hand
ST19_OTHER_COMPLICATIO_SURGI_MEDICAL_CARE_NOT_ELSEW_CLASSIFIED	"Other complications of surgical and medical care, not elsewhere classified"
ST19_OTHER_INJURI_UPPER_LIMB_LEVEL_UNSPE	"Other injuries of upper limb, level unspecified"
ST19_OTHER_SPECIFE_INJURI_HIP_THIGH1	Other and specified injuries of hip and thigh
ST19_OTHER_UNSPE_EFFEC_EXTER_CAUSES	Other and unspecified effects of external causes
ST19_OTHER_UNSPE_INJURI_ABDOMEN_LOWER_BACK_PELVIS	"Other and unspecified injuries of abdomen, lower back and pelvis"
ST19_OTHER_UNSPE_INJURI_ANKLE_FOOT	Other and unspecified injuries of ankle and foot
ST19_OTHER_UNSPE_INJURI_HEAD	Other and unspecified injuries of head
ST19_OTHER_UNSPE_INJURI_LOWER_LEG	Other and unspecified injuries of lower leg
ST19_OTHER_UNSPE_INJURI_NECK	Other and unspecified injuries of neck
ST19_OTHER_UNSPE_INJURI_SHOUL_UPPER_ARM	Other and unspecified injuries of shoulder and upper arm
ST19_OTHER_UNSPE_INJURI_THORAX	Other and unspecified injuries of thorax
ST19_OTHER_UNSPE_INJURI_WRIST_HAND	Other and unspecified injuries of wrist and hand
ST19_POISO_DRUGS_MEDICAM_BIOLO_SUBST	"Poisoning by drugs, medicaments and biological substances"
ST19_POISO_MEDICI	Poisoning by medicine
ST19_POISO_MEDICI_ADVERSE	"Poisoning by medicine, drug-induced"
ST19_POISO_NARCOT_PSYCHOD_HALLUCINOG	Poisoning by narcotics and psychodysleptics [hallucinogens]
ST19_POST_TRAU_WOUND_INFECTION_NOT_ELSEW_CLASSIFIED	"Post-traumatic wound infection, not elsewhere classified"
ST19_SEQUEL_INJURI_HEAD	Sequelae of injuries of head
ST19_SEQUEL_INJURI_LOWER_LIMB	Sequelae of injuries of lower limb
ST19_SEQUEL_INJURI_NECK_TRUNK	Sequelae of injuries of neck and trunk
ST19_SEQUEL_INJURI_POISO_OTHER_CONSE_EXTER_CAUSES	"Sequelae of injuries, of poisoning and of other consequences of external causes"
ST19_SEQUEL_INJURI_UPPER_LIMB	Sequelae of injuries of upper limb
ST19_SUPERF_FROST	Superficial frostbite
ST19_SUPERF_INJURI_INVOLVI_MULTIPLE_BODY_REGIONS	Superficial injuries involving multiple body regions
ST19_SUPERF_INJURY_ABDOMEN_LOWER_BACK_PELVIS	"Superficial injury of abdomen, lower back and pelvis"
ST19_SUPERF_INJURY_ANKLE_FOOT	Superficial injury of ankle and foot
ST19_SUPERF_INJURY_FOREA	Superficial injury of forearm
ST19_SUPERF_INJURY_HEAD	Superficial injury of head
ST19_SUPERF_INJURY_HIP_THIGH	Superficial injury of hip and thigh
ST19_SUPERF_INJURY_LOWER_LEG	Superficial injury of lower leg
ST19_SUPERF_INJURY_NECK	Superficial injury of neck
ST19_SUPERF_INJURY_SHOUL_UPPER_ARM	Superficial injury of shoulder and upper arm
ST19_SUPERF_INJURY_THORAX	Superficial injury of thorax
ST19_SUPERF_INJURY_WRIST_HAND	Superficial injury of wrist and hand
ST19_TOXIC_EFFECT_ALCOHOL	Toxic effect of alcohol
ST19_TOXIC_EFFECT_CARBON_MONOX	Toxic effect of carbon monoxide
ST19_TOXIC_EFFECT_CONTACT_W_VENOMO_ANIMALS	Toxic effect of contact with venomous animals
ST19_TOXIC_EFFECT_ETHAN	Toxic effect of ethanol
ST19_TOXIC_EFFECT_OTHER_GASES_FUMES_VAPOU	"Toxic effect of other gases, fumes and vapours"
ST19_TOXIC_EFFECT_OTHER_UNSPE_SUBST	Toxic effect of other and unspecified substances
ST19_TOXIC_EFFEC_SUBST_CHIEF_NONME_SOURCE	Toxic effects of substances chiefly nonmedicinal as to source
ST19_TRAUMAT_AMPUT_WRIST_HAND	Traumatic amputation of wrist and hand
ST19_TRAUMAT_ISCHA_MUSCLE	Traumatic ischaemia of muscle
ST19_TRAUMAT_SUBAR_HAEMORRHAGE	Traumatic subarachnoid haemorrhage
ST19_TRAUMAT_SUBDU_HAEMORRHAGE	Traumatic subdural haemorrhage
STILL_ADULT	Adult-onset Still disease
SYSTSCLE_FG	Systemic sclerosis (FG)
SYSTSCLE_ICD10	"Systemic sclerosis, icd10"
SYSTSCLE_STRICT	"Systemic sclerosis,strict definition"
T1D	"Type1 diabetes, definitions combined"
T1D_ICD9_10	Sub-endpoint used in defining T1D endpoints
T1D_STRICT	"Type 1 diabetes, strict definition"
T1D_STRICT1	"Type 1 diabetes, strict definition, subgroup 1"
T1D_STRICT2	"Type 1 diabetes, strict definition, subgroup 2"
T1D_WIDE	"Type 1 diabetes, wide definition"
T1D_WIDE1	"Type 1 diabetes, wide definition, subgroup 1"
T1D_WIDE2	"Type 1 diabetes, wide definition, subgroup 2"
T2D	"Type 2 diabetes, definitions combined"
T2D_INCLAVO	"Type 2 diabetes, definitions combined, including avohilmo"
T2D_WIDE	"Type 2 diabetes, wide definition"
TBC_OTHER_ORGANS	Tuberculosis of other organs
TBC_RESP	Respiratory tuberculosis
TBC_RESP_CLIN	"Respiratory tuberculosis, not confirmed bacteriologically or histologically"
TBC_RESP_HISTOBACT	"Respiratory tuberculosis, bacteriologically and histologically confirmed"
TBC_RESP_ICD8	"Respiratory TBC, ICD-8 codes not specifying whether confirmed bacteriologically or histologically"
TEMPOROMANDIB	Temporomandibular joint disorders
THROMBOCYTAEMIA	Essential (haemorrhagic) thrombocythaemia
THYROIDITIS	Thyroiditis
THYROIDITIS_ILD	"Thyroiditis, ILD-related definition"
THYROID_DISORDER_IBD	"Disorders of thyroid, IBD co-morbidities"
THYROTOXICOSIS	Thyrotoxicosis
TONGUEABNORMALITY	Tongue abnormality
TRAUMBRAIN_NONCONCUS	"severe traumatic brain injury, does not include concussion"
TUBERCULOSIS	Tuberculosis
ULCERENTER	Ulcerative enterocolitis
ULCERILEO	Ulcerative ileocolitis
ULCERNAS	"Ulcerative colitis, NAS"
ULCEROTH	Other ulcerative colitis
ULCERPROCT	Ulcerative proctitis
ULCERRECT	Ulcerative rectosigmoiditis
ULCER_ARTHR	Arthropathy in ulcerative colitis
VD_MI	Vascular dementia (multiple infarctations)
VD_MX	Vascular dementia (mixed)
VD_SC	Vascular dementia (subcortical)
VD_U	Vascular dementia (undefined)
VIRALPNEUMOKNOWN	"Viral pneumonia (known virus, not influenza)"
VIRALPNEUMONAS	"Viral pneumonia (unknown virus, not influenza)"
VIT_DEF	Vitamin deficiency
VOCALCORDDYS	Vocal cord dysfunction
VWXY20_ACCIDENTS	Accidents
VWXY20_BLOOD_ALCOHOL_ALCOHOL_INTOX_LEVEL	Blood alcohol or alcohol intoxication level
VWXY20_COMPLICATIO_MEDICAL_SURGI_CARE	Complications of medical and surgical care
VWXY20_EVIDE_ALCOHOL_INVOLVM_DETERM_BLOOD_ALCOHOL_LEVEL	Evidence of alcohol involvement determined by blood alcohol level
VWXY20_EVIDE_ALCOHOL_INVOLVM_DETERM_LEVEL_INTOX	Evidence of alcohol involvement determined by level of intoxication
VWXY20_FALL_SAME_LEVEL	Fall on same level
VWXY20_FALL_SAME_LEVEL_INVOLVI_ICE_SNOW	Fall on same level involving ice and snow
VWXY20_OTHER_EXTER_CAUSES_ACCIDENTAL_INJURY	Other external causes of accidental injury
VWXY20_SEQUEL_EXTER_CAUSES_MORBIDI_MORTA	Sequelae of external causes of morbidity and mortality
VWXY20_SUICI_OTHER_INTENTI_SELF_H	Suicide or other Intentional self-harm
VWXY20_SUPPLE_FACTO_RELATED_CAUSES_MORBIDI_MORTA_CLASSIFIED_ELSEW	Supplementary factors related to causes of morbidity and mortality classified elsewhere
VWXY20_SURGI_OTHER_MEDICAL_PROCED_CAUSE_ABNORMAL_REACTION_PATIENT_COMPLICATION_WO_MENTION_MISAD_TIME_PROCED	"Surgical and other medical procedures as the cause of abnormal reaction of the patient, or of later complication, without mention of misadventure at the time of the procedure"
VWXY20_TRANSPO_ACCIDENTS	Transport accidents
VWXY20_TYPE_ACCIDENT	Type of accident
VWXY20_UNSPE_FALL	Unspecified fall
VWXY20_VAPAA_TAPATURMAT	!!!Vapaa-ajan tapaturmat
WEIGHTLOSS	Weight loss
WET_AMD	Wet age-related macular degeneration
Z21_ACQUI_ABSENCE_LIMB	Acquired absence of limb
Z21_ACQUI_ABSENCE_ORGANS_NOT_ELSEW_CLASSIFIED	"Acquired absence of organs, not elsewhere classified"
Z21_ADDIT_CODES_LOCAT_DEFECT_INJURY_ILLNE	"Additional codes for the location of defect, injury or illness"
Z21_ADJUS_MANAG_IMPLANTNTED_DEVICE	Adjustment and management of implanted device
Z21_ALCOHOL_ABUSE_COUNSELLI_SURVE	Alcohol abuse counselling and surveillance
Z21_ANKLE_FOOT	Ankle and foot
Z21_ANTEN_SCREE	Antenatal screening
Z21_ARTIF_OPENI_STATUS	Artificial opening status
Z21_ASYMP_HUMAN_IMMUNODEFICIENCY_VIRUS_HIV_INFECTION_STATUS	Asymptomatic human immunodeficiency virus [HIV] infection status
Z21_ATTN_ARTIF_OPENI	Attention to artificial openings
Z21_CARE_INVOLVI_DIALY	Care involving dialysis
Z21_CARE_INVOLVI_USE_REHAB_PROCED	Care involving use of rehabilitation procedures
Z21_CARRIER_INFECTIOUS_DISEA	Carrier of infectious disease
Z21_CONTACT_W_EXPOS_COMMUNICAB_DISEA	Contact with and exposure to communicable diseases
Z21_CONTRACEPTIVE_MANAG	Contraceptive management
Z21_CONVALESCENCE	Convalescence
Z21_COUNSELLI_RELATED_SEXUAL_ATTIT_BEHVI_ORIEN	"Counselling related to sexual attitude, behaviour and orientation"
Z21_DEPENDENCE_ENABL_MACHINES_DEVICES_NOT_ELSEW_CLASSIFIED	"Dependence on enabling machines and devices, not elsewhere classified"
Z21_DESEN_ALLERGE	Desensitization to allergens
Z21_DONORS_ORGANS_TISSU	Donors of organs and tissues
Z21_EXAM_ENCOUNTER_ADMINISTR_PURPO	Examination and encounter for administrative purposes
Z21_EXAM_OBSER_OTH_REASO	Examination and observation for other reasons
Z21_FAMILY_HISTORY_CERTA_DISABILITI_CHRONIC_DISEA_LEADI_DISABL	Family history of certain disabilities and chronic diseases leading to disablement
Z21_FAMILY_HISTORY_MALIG_NEOPLASM	Family history of malignant neoplasm
Z21_FAMILY_HISTORY_OTH_SPECIFIC_DISORD	Family history of other specific disorders
Z21_FIT_ADJ_OTH_DEVICES	Fitting and adjustment of other devices
Z21_FOLLOW__CARE_INVOLVI_PLASTIC_SURGE	Follow-up care involving plastic surgery
Z21_FOLLOW__EXAM_TREAT_CONDI_OTH_MALIG_NEOPLASMS	Follow-up examination after treatment for conditions other than malignant neoplasms
Z21_FOLLOW__EXAM_TREAT_MALIG_NEOPLASMS	Follow-up examination after treatment for malignant neoplasms
Z21_GENERAL_EXAM_INVES_PERSONS_WO_COMPLA_REPOR_DIAGNOSIS	General examination and investigation of persons without complaint and reported diagnosis
Z21_LUNG_TRANSPLANT_STATUS	Lung transplant status
Z21_MEDICAL_OBSER_EVALU_SUSPECTED_DISEA_CONDI	Medical observation and evaluation for suspected diseases and conditions
Z21_NEED_IMMUNI_OTH_SINGLE_VIRAL_DISEA	Need for immunization against other single viral diseases
Z21_OCCUPAT_EXPOS_RISK_	Occupational exposure to risk-factors
Z21_OTHER_MEDICAL_CARE	Other medical care
Z21_OTHER_ORTHOPA_FOLLOW__CARE	Other orthopaedic follow-up care
Z21_OTHER_POSTS_STATES	Other postsurgical states
Z21_OTHER_PROBL_RELATED_PRIMARY_SUPPORT_GROUP_INCLU_FAMILY_CIRCUMSTANC	"Other problems related to primary support group, including family circumstances"
Z21_OTHER_SPECIAL_EXAM_INVES_PERSONS_WO_COMPLA_REPOR_DIAGNOSIS	Other special examinations and investigations of persons without complaint or reported diagnosis
Z21_OTHER_SURGI_FOLLOW__CARE	Other surgical follow-up care
Z21_OUTCO_DELIV	Outcome of delivery
Z21_PERSONAL_HISTORY_CERTA_OTH_DISEA	Personal history of certain other diseases
Z21_PERSONAL_HISTORY_MALIG_NEOPLASM	Personal history of malignant neoplasm
Z21_PERSONAL_HISTORY_OTH_DISEA_CONDI	Personal history of other diseases and conditions
Z21_PERSONAL_HISTORY_RISK__NOT_ELSEW_CLASSIFIED	"Personal history of risk-factors, not elsewhere classified"
Z21_PERSONS_ENCOUNTERI_HEALTH_SERVI_CIRCUMSTANC_RELATED_REPRODUCTION	Persons encountering health services in circumstances related to reproduction
Z21_PERSONS_ENCOUNTERI_HEALTH_SERVI_EXAM_INVES	Persons encountering health services for examination and investigation
Z21_PERSONS_ENCOUNTERI_HEALTH_SERVI_OTH_CIRCUMSTANC1	Persons encountering health services in other circumstances
Z21_PERSONS_ENCOUNTERI_HEALTH_SERVI_OTH_CIRCUMSTANC2	Persons encountering health services in other circumstances
Z21_PERSONS_ENCOUNTERI_HEALTH_SERVI_OTH_COUNSELLI_MEDICAL_ADVICE_NOT_ELSEW_CLASSIFIED	"Persons encountering health services for other counselling and medical advice, not elsewhere classified"
Z21_PERSONS_ENCOUNTERI_HEALTH_SERVI_SPECIFIC_PROCED_HEALTH_CARE	Persons encountering health services for specific procedures and health care
Z21_PERSONS_ENCOUNTERI_HEALTH_SERVI_SPECIFIC_PROCED_NOT_CARRIED	"Persons encountering health services for specific procedures, not carried out"
Z21_PERSONS_W_POTEN_HEALTH_HAZARDS_RELATED_COMMUNICAB_DISEA	Persons with potential health hazards related to communicable diseases
Z21_PERSONS_W_POTEN_HEALTH_HAZARDS_RELATED_FAMILY_PERSONAL_HISTORY_CERTA_CONDI_INFLUENCI_HEALTH_STATUS	Persons with potential health hazards related to family and personal history and certain conditions influencing health status
Z21_PERSONS_W_POTEN_HEALTH_HAZARDS_RELATED_SOCIO_PSYCHOSO_CIRCUMSTANC	Persons with potential health hazards related to socioeconomic and psychosocial circumstances
Z21_POSTPA_CARE_EXAMI	Postpartum care and examination
Z21_PREGNAC_EXAM_TEST	Pregnancy examination and test
Z21_PRESENCE_CARDIAC_VASCULAR_IMPLANTNTS_GRAFTS	Presence of cardiac and vascular implants and grafts
Z21_PRESENCE_OTH_DEVICES	Presence of other devices
Z21_PRESENCE_OTH_FUNCTIONAL_IMPLANTNTS	Presence of other functional implants
Z21_PROBL_RELATED_CARE__DEPENDENCY	Problems related to care-provider dependency
Z21_PROBL_RELATED_CERTA_PSYCHOSO_CIRCUMSTANC	Problems related to certain psychosocial circumstances
Z21_PROBL_RELATED_EMPLO_UNEMP	Problems related to employment and unemployment
Z21_PROBL_RELATED_HOUSI_ECONO_CIRCUMSTANC	Problems related to housing and economic circumstances
Z21_PROBL_RELATED_LIFESTYLE	Problems related to lifestyle
Z21_PROBL_RELATED_LIFE_M_DIFFICULTY	Problems related to life-management difficulty
Z21_PROBL_RELATED_MEDICAL_FACILITI_OTH_HEALTH_CARE	Problems related to medical facilities and other health care
Z21_PROBL_RELATED_NEGAT_LIFE_EVENTS_CHILDH	Problems related to negative life events in childhood
Z21_PROBL_RELATED_OTH_PSYCHOSO_CIRCUMSTANC	Problems related to other psychosocial circumstances
Z21_PROBL_RELATED_PHYSIC_ENVIRONMENT	Problems related to physical environment
Z21_PROBL_RELATED_SOCIAL_ENVIRONMENT	Problems related to social environment
Z21_PROCED_PURPO_OTH_REMED_HEALTH_STATE	Procedures for purposes other than remedying health state
Z21_PROCREATIVE_MANAG	Procreative management
Z21_ROUTI_GENERAL_HEALTH_CHECK_DEFIN_SUBPO	Routine general health check-up of defined subpopulation
Z21_SHOUL_REGION	Shoulder region
Z21_SPECIAL_SCREEN_EXAM_INFECTIOUS_PARASITIC_DISEA	Special screening examination for infectious and parasitic diseases
Z21_SPECIAL_SCREEN_EXAM_NEOPLASMS	Special screening examination for neoplasms
Z21_SPECIAL_SCREEN_EXAM_OTH_DISEA_DISORD	Special screening examination for other diseases and disorders
Z21_SUPERV_HIGH_R_PREGNAC	Supervision of high-risk pregnancy
Z21_SUPERV_NORMAL_PREGNAC1	Supervision of normal pregnancy
Z21_TOBAC_USE	Tobacco use
Z21_TRANSPLANTED_ORGAN_TISSUE_STATUS	Transplanted organ and tissue status
